doi,references_found,citations_found,api,retrieval_timestamp,references_OpenAlex,references_SemanticScholar,references_Overlap,references_OpenAlex_unique,references_SemanticScholar_unique,references_Total_unique,citations_OpenAlex,citations_SemanticScholar,citations_Overlap,citations_OpenAlex_unique,citations_SemanticScholar_unique,citations_Total_unique
10.1089/cyber.2013.0466,28,63,CompositeAPI,2025-07-02T19:17:05.781174+00:00,28,0,0,28,0,28,59,53,49,10,4,63
10.1108/itp-07-2023-0676,117,1,CompositeAPI,2025-07-02T19:17:09.997777+00:00,100,111,94,6,17,117,1,1,1,0,0,1
10.1016/s0747-5632(02)00016-x,14,145,CompositeAPI,2025-07-02T19:17:16.018900+00:00,14,0,0,14,0,14,134,128,117,17,11,145
10.1123/pes.2012-0128,0,14,CompositeAPI,2025-07-02T19:17:20.098998+00:00,0,0,0,0,0,0,14,13,13,1,0,14
10.1093/aje/kws590,21,149,CompositeAPI,2025-07-02T19:17:23.053572+00:00,21,0,0,21,0,21,149,0,0,149,0,149
10.1037/ppm0000203,85,590,CompositeAPI,2025-07-02T19:17:27.272345+00:00,85,0,0,85,0,85,558,445,413,145,32,590
10.1080/1369118x.2011.562223,25,45,CompositeAPI,2025-07-02T19:17:37.681674+00:00,25,0,0,25,0,25,44,30,29,15,1,45
10.1080/0144929x.2024.2406255,103,2,CompositeAPI,2025-07-02T19:17:41.711275+00:00,86,94,77,9,17,103,2,2,2,0,0,2
10.1007/s40429-022-00412-z,31,12,CompositeAPI,2025-07-02T19:17:47.680055+00:00,31,0,0,31,0,31,12,11,11,1,0,12
10.1007/s12144-020-01314-x,25,22,CompositeAPI,2025-07-02T19:17:51.641833+00:00,25,0,0,25,0,25,22,20,20,2,0,22
10.1111/j.1460-2466.2003.tb02590.x,22,80,CompositeAPI,2025-07-02T19:17:55.700304+00:00,22,0,0,22,0,22,79,71,70,9,1,80
10.1016/j.smrv.2024.101933,118,37,CompositeAPI,2025-07-02T19:17:59.920390+00:00,111,111,104,7,7,118,35,33,31,4,2,37
10.1177/009365000027002005,32,325,CompositeAPI,2025-07-02T19:18:07.080306+00:00,32,0,0,32,0,32,310,297,282,28,15,325
10.1002/casp.2138,46,12,CompositeAPI,2025-07-02T19:18:13.864036+00:00,46,0,0,46,0,46,12,11,11,1,0,12
10.12809/eaapl946,0,0,CompositeAPI,2025-07-02T19:18:17.918310+00:00,0,0,0,0,0,0,0,0,0,0,0,0
10.1177/107769900207900412,0,144,CompositeAPI,2025-07-02T19:18:18.856332+00:00,0,0,0,0,0,0,134,132,122,12,10,144
10.1111/j.1083-6101.2002.tb00143.x,36,56,CompositeAPI,2025-07-02T19:18:22.796875+00:00,36,0,0,36,0,36,47,50,41,6,9,56
10.1016/j.rpsp.2016.07.001,28,3,CompositeAPI,2025-07-02T19:18:26.974867+00:00,27,26,25,2,1,28,3,2,2,1,0,3
10.1177/0093650216686877,75,72,CompositeAPI,2025-07-02T19:18:31.018412+00:00,75,0,0,75,0,75,69,59,56,13,3,72
10.1093/ej/ueae091,43,2,CompositeAPI,2025-07-02T19:18:37.407019+00:00,43,0,0,43,0,43,2,2,2,0,0,2
10.1007/978-3-319-28640-2_4,31,54,CompositeAPI,2025-07-02T19:18:41.492069+00:00,31,0,0,31,0,31,47,35,28,19,7,54
10.1089/g4h.2017.0177,45,8,CompositeAPI,2025-07-02T19:18:45.801069+00:00,45,0,0,45,0,45,7,7,6,1,1,8
10.1080/17482798.2024.2443662,73,1,CompositeAPI,2025-07-02T19:18:49.910693+00:00,73,0,0,73,0,73,1,1,1,0,0,1
10.1207/s15506878jobem5004_5,44,134,CompositeAPI,2025-07-02T19:18:55.066546+00:00,44,0,0,44,0,44,128,110,104,24,6,134
10.2196/57198,24,0,CompositeAPI,2025-07-02T19:19:00.976963+00:00,23,24,23,0,1,24,0,0,0,0,0,0
10.2307/1162367,0,16,CompositeAPI,2025-07-02T19:19:02.640959+00:00,0,0,0,0,0,0,16,0,0,16,0,16
10.1111/j.1467-6451.2007.00316.x,10,139,CompositeAPI,2025-07-02T19:19:05.395617+00:00,10,0,0,10,0,10,125,110,96,29,14,139
10.1007/s10389-019-01043-x,51,61,CompositeAPI,2025-07-02T19:19:09.337127+00:00,51,0,0,51,0,51,57,47,43,14,4,61
10.1177/1461444809342558,17,61,CompositeAPI,2025-07-02T19:19:15.051003+00:00,17,0,0,17,0,17,60,39,38,22,1,61
10.3316/informit.414140549600484,0,0,CompositeAPI,2025-07-02T19:19:18.286769+00:00,0,0,0,0,0,0,0,0,0,0,0,0
10.1016/s2352-4642(19)30424-9,31,41,CompositeAPI,2025-07-02T19:19:19.194543+00:00,31,0,0,31,0,31,40,29,28,12,1,41
10.1007/s11205-010-9653-0,31,18,CompositeAPI,2025-07-02T19:19:23.619527+00:00,24,24,17,7,7,31,16,12,10,6,2,18
10.1515/commun-2014-0028,40,14,CompositeAPI,2025-07-02T19:19:27.680822+00:00,40,0,0,40,0,40,14,0,0,14,0,14
10.1111/jsr.12510,23,88,CompositeAPI,2025-07-02T19:19:31.794256+00:00,23,0,0,23,0,23,84,74,70,14,4,88
10.4324/9780203855102,0,89,CompositeAPI,2025-07-02T19:19:35.188632+00:00,0,0,0,0,0,0,74,36,21,53,15,89
10.1177/0265407519836170,61,407,CompositeAPI,2025-07-02T19:19:38.140254+00:00,61,0,0,61,0,61,383,324,300,83,24,407
10.1093/restud/rdy028,65,122,CompositeAPI,2025-07-02T19:19:46.064650+00:00,65,0,0,65,0,65,122,0,0,122,0,122
10.1016/j.jaac.2019.11.023,7,1,CompositeAPI,2025-07-02T19:19:52.964062+00:00,7,0,0,7,0,7,1,1,1,0,0,1
10.1016/j.chb.2010.07.015,82,554,CompositeAPI,2025-07-02T19:19:55.858945+00:00,82,0,0,82,0,82,518,449,413,105,36,554
10.1016/j.actpsy.2021.103454,104,31,CompositeAPI,2025-07-02T19:20:06.597303+00:00,79,100,75,4,25,104,29,26,24,5,2,31
10.1016/j.tele.2024.102212,86,0,CompositeAPI,2025-07-02T19:20:12.723070+00:00,86,0,0,86,0,86,0,0,0,0,0,0
10.1177/009365093020001003,30,153,CompositeAPI,2025-07-02T19:20:17.535662+00:00,30,0,0,30,0,30,147,108,102,45,6,153
10.1177/0093650210384988,47,124,CompositeAPI,2025-07-02T19:20:22.607782+00:00,47,0,0,47,0,47,116,107,99,17,8,124
10.1016/j.adolescence.2010.11.009,31,21,CompositeAPI,2025-07-02T19:20:28.341332+00:00,31,0,0,31,0,31,20,18,17,3,1,21
2775789439,0,4,CompositeAPI,2025-07-02T19:20:32.552005+00:00,0,0,0,0,0,0,2,3,1,1,2,4
10.1177/089443939701500107,10,73,CompositeAPI,2025-07-02T19:20:35.381779+00:00,10,0,0,10,0,10,69,51,47,22,4,73
10.4324/9781315736495-6,1,4,CompositeAPI,2025-07-02T19:20:38.756318+00:00,1,0,0,1,0,1,3,4,3,0,1,4
10.1007/s10660-020-09421-4,39,2,CompositeAPI,2025-07-02T19:20:41.644503+00:00,39,0,0,39,0,39,2,0,0,2,0,2
10.3390/children9081186,40,0,CompositeAPI,2025-07-02T19:20:45.811068+00:00,37,38,35,2,3,40,0,0,0,0,0,0
10.1111/ijsw.12609,42,4,CompositeAPI,2025-07-02T19:20:48.342992+00:00,42,0,0,42,0,42,4,4,4,0,0,4
10.1016/j.infbeh.2020.101509,70,40,CompositeAPI,2025-07-02T19:20:52.324918+00:00,70,0,0,70,0,70,40,33,33,7,0,40
10.2501/jar-53-1-071-082,9,30,CompositeAPI,2025-07-02T19:20:57.597851+00:00,9,0,0,9,0,9,29,22,21,8,1,30
10.1111/j.1460-2466.2008.00401_2.x,0,0,CompositeAPI,2025-07-02T19:21:00.809563+00:00,0,0,0,0,0,0,0,0,0,0,0,0
10.1111/j.1468-2958.1987.tb00120.x,23,46,CompositeAPI,2025-07-02T19:21:02.011311+00:00,23,0,0,23,0,23,45,39,38,7,1,46
10.23750/abm.v95i5.15826,0,0,CompositeAPI,2025-07-02T19:21:06.398521+00:00,0,0,0,0,0,0,0,0,0,0,0,0
10.1177/2167702618778562,7,15,CompositeAPI,2025-07-02T19:21:07.430920+00:00,7,0,0,7,0,7,14,11,10,4,1,15
10.3389/fhumd.2021.585906,26,1,CompositeAPI,2025-07-02T19:21:10.813657+00:00,22,25,21,1,4,26,1,0,0,1,0,1
10.1016/j.tourman.2008.12.012,52,153,CompositeAPI,2025-07-02T19:21:13.869108+00:00,52,0,0,52,0,52,146,120,113,33,7,153
10.1080/10494820.2022.2160765,6,3,CompositeAPI,2025-07-02T19:21:19.997988+00:00,6,0,0,6,0,6,3,3,3,0,0,3
10.1177/2167479516688438,48,41,CompositeAPI,2025-07-02T19:21:22.962330+00:00,48,0,0,48,0,48,40,30,29,11,1,41
10.3389/fpsyg.2021.742468,75,7,CompositeAPI,2025-07-02T19:21:28.249493+00:00,65,74,64,1,10,75,7,6,6,1,0,7
10.1080/14616700802337768,3,75,CompositeAPI,2025-07-02T19:21:33.424445+00:00,3,0,0,3,0,3,65,66,56,9,10,75
10.1108/apjml-05-2020-0377,59,4,CompositeAPI,2025-07-02T19:21:36.629217+00:00,59,0,0,59,0,59,4,1,1,3,0,4
10.1371/journal.pone.0257877,49,16,CompositeAPI,2025-07-02T19:21:41.627865+00:00,46,46,43,3,3,49,15,14,13,2,1,16
10.1080/1369118x.2016.1164740,41,115,CompositeAPI,2025-07-02T19:21:46.004449+00:00,41,0,0,41,0,41,106,86,77,29,9,115
10.3102/00346543051002193,30,96,CompositeAPI,2025-07-02T19:21:52.202045+00:00,30,0,0,30,0,30,89,92,85,4,7,96
10.1016/j.econedurev.2017.01.001,30,36,CompositeAPI,2025-07-02T19:21:56.720657+00:00,30,0,0,30,0,30,27,25,16,11,9,36
10.1111/jftr.12384,79,7,CompositeAPI,2025-07-02T19:22:01.017800+00:00,79,0,0,79,0,79,7,5,5,2,0,7
10.1016/j.sleh.2015.11.003,51,160,CompositeAPI,2025-07-02T19:22:07.220997+00:00,51,0,0,51,0,51,150,123,113,37,10,160
10.1111/apa.12935,26,29,CompositeAPI,2025-07-02T19:22:13.445565+00:00,26,0,0,26,0,26,27,29,27,0,2,29
10.1007/s12187-019-09675-x,47,46,CompositeAPI,2025-07-02T19:22:17.618582+00:00,47,0,0,47,0,47,46,0,0,46,0,46
10.1016/j.actpsy.2024.104674,123,1,CompositeAPI,2025-07-02T19:22:22.839864+00:00,123,0,0,123,0,123,0,1,0,0,1,1
10.1186/1471-2458-9-146,39,40,CompositeAPI,2025-07-02T19:22:28.674586+00:00,39,0,0,39,0,39,40,0,0,40,0,40
10.1111/0038-4941.00026,13,118,CompositeAPI,2025-07-02T19:22:33.090791+00:00,13,0,0,13,0,13,114,103,99,15,4,118
10.1007/bf02895662,41,91,CompositeAPI,2025-07-02T19:22:37.191541+00:00,41,0,0,41,0,41,86,81,76,10,5,91
10.1016/j.adolescence.2013.11.003,44,192,CompositeAPI,2025-07-02T19:22:41.448223+00:00,44,0,0,44,0,44,183,158,149,34,9,192
10.1089/cyber.2022.0057,10,1,CompositeAPI,2025-07-02T19:22:47.918647+00:00,10,0,0,10,0,10,1,0,0,1,0,1
10.1111/cdev.13953,49,5,CompositeAPI,2025-07-02T19:22:50.849234+00:00,49,0,0,49,0,49,5,5,5,0,0,5
10.1177/20501579221134168,49,5,CompositeAPI,2025-07-02T19:22:55.730386+00:00,49,0,0,49,0,49,5,4,4,1,0,5
10.1080/1369118x.2010.539243,26,39,CompositeAPI,2025-07-02T19:23:00.585329+00:00,26,0,0,26,0,26,36,31,28,8,3,39
10.1177/1461444809356334,40,30,CompositeAPI,2025-07-02T19:23:04.624771+00:00,40,0,0,40,0,40,24,30,24,0,6,30
10.1016/j.jpeds.2018.09.054,28,103,CompositeAPI,2025-07-02T19:23:08.674622+00:00,28,0,0,28,0,28,96,86,79,17,7,103
10.1080/10810730.2016.1157651,63,41,CompositeAPI,2025-07-02T19:23:12.904191+00:00,63,0,0,63,0,63,39,26,24,15,2,41
10.1177/1354856514541928,21,32,CompositeAPI,2025-07-02T19:23:19.679149+00:00,21,0,0,21,0,21,32,29,29,3,0,32
10.1177/2333794x19878062,37,21,CompositeAPI,2025-07-02T19:23:23.106391+00:00,33,34,30,3,4,37,20,13,12,8,1,21
10.1037/dev0000851,70,51,CompositeAPI,2025-07-02T19:23:27.247489+00:00,70,0,0,70,0,70,47,39,35,12,4,51
10.1016/j.chb.2015.03.073,29,25,CompositeAPI,2025-07-02T19:23:33.394743+00:00,29,0,0,29,0,29,23,24,22,1,2,25
10.1007/s40675-019-00146-x,95,55,CompositeAPI,2025-07-02T19:23:37.422215+00:00,95,0,0,95,0,95,52,43,40,12,3,55
10.2501/s026504870909043x,0,36,CompositeAPI,2025-07-02T19:23:43.749881+00:00,0,0,0,0,0,0,32,33,29,3,4,36
10.1016/j.tele.2015.08.002,40,16,CompositeAPI,2025-07-02T19:23:46.876787+00:00,40,0,0,40,0,40,16,13,13,3,0,16
1550314631,39,55,CompositeAPI,2025-07-02T19:23:50.907782+00:00,39,0,0,39,0,39,41,37,23,18,14,55
10.1177/0033294117742657,25,11,CompositeAPI,2025-07-02T19:23:56.185665+00:00,25,0,0,25,0,25,10,9,8,2,1,11
10.1016/j.sleep.2021.02.045,62,7,CompositeAPI,2025-07-02T19:23:59.452902+00:00,62,0,0,62,0,62,7,0,0,7,0,7
10.1111/jcpp.13282,31,47,CompositeAPI,2025-07-02T19:24:04.535813+00:00,26,29,24,2,5,31,44,37,34,10,3,47
10.1177/000494419303700207,27,18,CompositeAPI,2025-07-02T19:24:08.706212+00:00,27,0,0,27,0,27,17,17,16,1,1,18
10.4278/ajhp.07053050,18,11,CompositeAPI,2025-07-02T19:24:12.900903+00:00,17,13,12,5,1,18,10,9,8,2,1,11
10.1186/s12889-020-09894-w,37,17,CompositeAPI,2025-07-02T19:24:16.207892+00:00,35,35,33,2,2,37,15,14,12,3,2,17
10.1080/15213269.2019.1624177,52,39,CompositeAPI,2025-07-02T19:24:20.401626+00:00,52,0,0,52,0,52,39,33,33,6,0,39
10.1207/s15506878jobem4402_4,15,210,CompositeAPI,2025-07-02T19:24:25.552212+00:00,15,0,0,15,0,15,195,183,168,27,15,210
10.1177/2050157914550663,28,58,CompositeAPI,2025-07-02T19:24:30.383112+00:00,28,0,0,28,0,28,57,37,36,21,1,58
10.1071/he12058,33,121,CompositeAPI,2025-07-02T19:24:35.045165+00:00,33,0,0,33,0,33,114,99,92,22,7,121
10.1111/ijsw.70012,37,0,CompositeAPI,2025-07-02T19:24:40.377229+00:00,37,0,0,37,0,37,0,0,0,0,0,0
10.1155/2022/1402751,46,19,CompositeAPI,2025-07-02T19:24:43.106765+00:00,44,38,36,8,2,46,19,15,15,4,0,19
10.4018/978-1-4666-0315-8.ch030,19,0,CompositeAPI,2025-07-02T19:24:47.246843+00:00,19,0,0,19,0,19,0,0,0,0,0,0
10.1017/s0021849904040073,17,44,CompositeAPI,2025-07-02T19:24:48.782929+00:00,17,0,0,17,0,17,42,38,36,6,2,44
10.1177/0044118x19868365,63,36,CompositeAPI,2025-07-02T19:24:52.340007+00:00,63,0,0,63,0,63,36,20,20,16,0,36
10.1177/20501579221077525,55,12,CompositeAPI,2025-07-02T19:24:58.106321+00:00,55,0,0,55,0,55,12,9,9,3,0,12
10.1027/1864-1105/a000388,59,6,CompositeAPI,2025-07-02T19:25:03.027518+00:00,59,0,0,59,0,59,6,4,4,2,0,6
2943800371,0,37,CompositeAPI,2025-07-02T19:25:07.901586+00:00,0,0,0,0,0,0,28,30,21,7,9,37
10.1093/aje/kwp163,29,446,CompositeAPI,2025-07-02T19:25:11.096593+00:00,29,0,0,29,0,29,443,131,128,315,3,446
10.3390/ijerph18063227,175,30,CompositeAPI,2025-07-02T19:25:19.338581+00:00,167,160,152,15,8,175,26,21,17,9,4,30
10.2196/22740,71,59,CompositeAPI,2025-07-02T19:25:29.660482+00:00,66,65,60,6,5,71,58,48,47,11,1,59
10.1038/s41390-022-02261-y,62,37,CompositeAPI,2025-07-02T19:25:34.963042+00:00,58,57,53,5,4,62,33,31,27,6,4,37
10.1159/000086877,7,0,CompositeAPI,2025-07-02T19:25:40.132215+00:00,7,0,0,7,0,7,0,0,0,0,0,0
10.1287/mksc.2022.0080,19,10,CompositeAPI,2025-07-02T19:25:43.104495+00:00,13,13,7,6,6,19,8,6,4,4,2,10
10.1080/00140130903067789,97,91,CompositeAPI,2025-07-02T19:25:46.176295+00:00,97,0,0,97,0,97,90,77,76,14,1,91
10.3389/fpsyg.2020.01734,48,34,CompositeAPI,2025-07-02T19:25:54.413794+00:00,41,44,37,4,7,48,33,26,25,8,1,34
10.1186/s12966-015-0280-7,37,139,CompositeAPI,2025-07-02T19:25:58.799865+00:00,34,31,28,6,3,37,135,125,121,14,4,139
10.1177/0267323102017003692,11,32,CompositeAPI,2025-07-02T19:26:04.185316+00:00,11,0,0,11,0,11,25,28,21,4,7,32
10.1016/j.chb.2014.05.004,116,82,CompositeAPI,2025-07-02T19:26:07.841524+00:00,116,0,0,116,0,116,74,65,57,17,8,82
10.1080/1369118x.2018.1430162,35,98,CompositeAPI,2025-07-02T19:26:16.316720+00:00,35,0,0,35,0,35,95,64,61,34,3,98
10.1016/j.jad.2025.04.032,63,0,CompositeAPI,2025-07-02T19:26:20.719802+00:00,63,0,0,63,0,63,0,0,0,0,0,0
10.1016/j.chc.2005.03.001,54,23,CompositeAPI,2025-07-02T19:26:24.190066+00:00,54,0,0,54,0,54,18,21,16,2,5,23
10.1002/hbe2.139,72,199,CompositeAPI,2025-07-02T19:26:29.529702+00:00,72,68,68,4,0,72,191,157,149,42,8,199
10.1016/j.mhpa.2020.100344,39,7,CompositeAPI,2025-07-02T19:26:36.481171+00:00,39,0,0,39,0,39,6,7,6,0,1,7
10.1016/j.jadohealth.2024.11.020,0,0,CompositeAPI,2025-07-02T19:26:40.601915+00:00,0,0,0,0,0,0,0,0,0,0,0,0
10.1007/s40501-024-00312-1,62,6,CompositeAPI,2025-07-02T19:26:41.841757+00:00,62,0,0,62,0,62,6,5,5,1,0,6
10.1177/146642400312400110,21,313,CompositeAPI,2025-07-02T19:26:47.234212+00:00,21,0,0,21,0,21,298,280,265,33,15,313
10.1016/j.chb.2024.108235,85,14,CompositeAPI,2025-07-02T19:26:53.102810+00:00,82,78,75,7,3,85,13,13,12,1,1,14
10.1016/j.compedu.2019.103704,32,37,CompositeAPI,2025-07-02T19:26:59.063944+00:00,32,0,0,32,0,32,37,30,30,7,0,37
10.2307/747641,16,185,CompositeAPI,2025-07-02T19:27:03.419804+00:00,16,0,0,16,0,16,175,141,131,44,10,185
10.1177/1745691617713052,135,597,CompositeAPI,2025-07-02T19:27:08.573537+00:00,135,0,0,135,0,135,570,459,432,138,27,597
10.1177/2057150x221121698,32,4,CompositeAPI,2025-07-02T19:27:21.405561+00:00,32,0,0,32,0,32,3,3,2,1,1,4
10.1051/shsconf/20173300065,18,4,CompositeAPI,2025-07-02T19:29:39.471331+00:00,18,18,18,0,0,18,2,4,2,0,2,4
10.1093/ct/qtad016,122,20,CompositeAPI,2025-07-02T19:29:42.568655+00:00,116,112,106,10,6,122,20,18,18,2,0,20
10.1163/15685314-04601008,0,5,CompositeAPI,2025-07-02T19:29:49.587116+00:00,0,0,0,0,0,0,5,5,5,0,0,5
10.1177/02654075221087942,108,36,CompositeAPI,2025-07-02T19:29:52.215415+00:00,108,0,0,108,0,108,35,29,28,7,1,36
10.1016/j.tele.2011.06.001,18,103,CompositeAPI,2025-07-02T19:29:59.298677+00:00,18,0,0,18,0,18,100,88,85,15,3,103
10.1093/oxfordhb/9780195393002.013.0024,0,1,CompositeAPI,2025-07-02T19:30:03.234114+00:00,0,0,0,0,0,0,1,0,0,1,0,1
10.1016/j.sleep.2017.09.002,55,16,CompositeAPI,2025-07-02T19:30:06.122007+00:00,54,48,47,7,1,55,16,14,14,2,0,16
10.1093/acprof:oso/9780195312805.003.0012,0,13,CompositeAPI,2025-07-02T19:30:11.331169+00:00,0,0,0,0,0,0,13,3,3,10,0,13
10.3389/fpsyt.2022.981881,98,23,CompositeAPI,2025-07-02T19:30:14.069075+00:00,89,93,84,5,9,98,22,19,18,4,1,23
10.4018/978-1-5225-9412-3.ch009,73,3,CompositeAPI,2025-07-02T19:30:20.323773+00:00,73,0,0,73,0,73,2,2,1,1,1,3
10.1093/jcmc/zmaa010,52,6,CompositeAPI,2025-07-02T19:30:25.409274+00:00,52,0,0,52,0,52,6,5,5,1,0,6
10.1080/1369118x.2013.777760,45,96,CompositeAPI,2025-07-02T19:30:30.663292+00:00,45,0,0,45,0,45,95,68,67,28,1,96
10.1027/1864-1105/a000038,69,28,CompositeAPI,2025-07-02T19:30:35.850810+00:00,69,0,0,69,0,69,28,24,24,4,0,28
10.1016/j.chb.2014.04.003,58,131,CompositeAPI,2025-07-02T19:30:41.914389+00:00,58,0,0,58,0,58,120,92,81,39,11,131
10.1177/089443938800600204,18,39,CompositeAPI,2025-07-02T19:30:47.728740+00:00,18,0,0,18,0,18,33,25,19,14,6,39
10.1016/j.socscimed.2019.05.030,92,56,CompositeAPI,2025-07-02T19:30:50.878814+00:00,92,0,0,92,0,92,51,39,34,17,5,56
10.5546/aap.2024-10451.eng,14,2,CompositeAPI,2025-07-02T19:30:57.186873+00:00,0,14,0,0,14,14,2,1,1,1,0,2
10.1016/s0031-3955(05)70354-0,43,450,CompositeAPI,2025-07-02T19:30:59.998714+00:00,43,0,0,43,0,43,422,394,366,56,28,450
10.1177/0963721419838244,38,265,CompositeAPI,2025-07-02T19:31:08.572947+00:00,38,0,0,38,0,38,246,182,163,83,19,265
10.1080/1369118x.2024.2317898,38,2,CompositeAPI,2025-07-02T19:31:14.798225+00:00,38,0,0,38,0,38,1,1,0,1,1,2
10.1093/oxfordhb/9780199873630.013.0009,0,7,CompositeAPI,2025-07-02T19:31:18.962140+00:00,0,0,0,0,0,0,4,6,3,1,3,7
10.1016/j.chbr.2023.100293,30,2,CompositeAPI,2025-07-02T19:31:21.685390+00:00,29,27,26,3,1,30,2,2,2,0,0,2
10.1038/nrendo.2010.133,95,72,CompositeAPI,2025-07-02T19:31:25.668115+00:00,95,0,0,95,0,95,70,57,55,15,2,72
10.1123/jpah.9.7.977,30,76,CompositeAPI,2025-07-02T19:31:33.645367+00:00,30,0,0,30,0,30,64,65,53,11,12,76
10.1080/08997764.2011.601974,30,59,CompositeAPI,2025-07-02T19:31:37.846562+00:00,30,0,0,30,0,30,59,14,14,45,0,59
10.1177/20501579231185479,54,5,CompositeAPI,2025-07-02T19:31:42.079601+00:00,44,49,39,5,10,54,5,4,4,1,0,5
10.1037/0000100-023,0,4,CompositeAPI,2025-07-02T19:31:45.981432+00:00,0,0,0,0,0,0,4,1,1,3,0,4
10.1037/ppm0000479,0,0,CompositeAPI,2025-07-02T19:31:48.515699+00:00,0,0,0,0,0,0,0,0,0,0,0,0
10.1080/16522354.2024.2418718,58,1,CompositeAPI,2025-07-02T19:31:49.860336+00:00,57,45,44,13,1,58,1,1,1,0,0,1
10.1080/01292986.2012.725179,41,12,CompositeAPI,2025-07-02T19:31:54.739674+00:00,41,0,0,41,0,41,11,10,9,2,1,12
10.1207/s15506878jobem4403_1,23,104,CompositeAPI,2025-07-02T19:31:58.757307+00:00,23,0,0,23,0,23,104,7,7,97,0,104
10.1007/s40124-023-00290-7,37,1,CompositeAPI,2025-07-02T19:32:03.801485+00:00,37,0,0,37,0,37,1,1,1,0,0,1
10.1055/s-0038-1626338,19,12,CompositeAPI,2025-07-02T19:32:07.806907+00:00,19,0,0,19,0,19,9,11,8,1,3,12
10.1016/j.tele.2020.101558,46,11,CompositeAPI,2025-07-02T19:32:10.821252+00:00,46,0,0,46,0,46,10,7,6,4,1,11
10.1080/10810730.2020.1746868,57,30,CompositeAPI,2025-07-02T19:32:14.912778+00:00,57,0,0,57,0,57,30,25,25,5,0,30
10.3389/fpsyg.2022.985112,102,12,CompositeAPI,2025-07-02T19:32:20.119145+00:00,96,97,91,5,6,102,11,9,8,3,1,12
10.1515/commun-2020-0028,33,9,CompositeAPI,2025-07-02T19:32:27.219651+00:00,33,0,0,33,0,33,8,6,5,3,1,9
10.3200/gntp.165.4.367-382,20,100,CompositeAPI,2025-07-02T19:32:31.722183+00:00,20,0,0,20,0,20,92,73,65,27,8,100
10.1177/1463949117714080,34,10,CompositeAPI,2025-07-02T19:32:35.734422+00:00,34,0,0,34,0,34,10,9,9,1,0,10
10.1111/jcc4.12183,51,179,CompositeAPI,2025-07-02T19:32:39.785988+00:00,51,0,0,51,0,51,176,141,138,38,3,179
10.1177/0267323112453672,30,11,CompositeAPI,2025-07-02T19:32:45.961877+00:00,30,0,0,30,0,30,11,8,8,3,0,11
10.1111/j.1467-9663.2008.00494.x,54,36,CompositeAPI,2025-07-02T19:32:49.879042+00:00,54,0,0,54,0,54,36,32,32,4,0,36
10.1016/j.infoecopol.2023.101045,24,4,CompositeAPI,2025-07-02T19:32:55.461760+00:00,21,19,16,5,3,24,3,3,2,1,1,4
10.1007/s11205-015-1227-8,42,106,CompositeAPI,2025-07-02T19:32:58.563775+00:00,42,0,0,42,0,42,101,89,84,17,5,106
10.1007/s11205-010-9656-x,20,30,CompositeAPI,2025-07-02T19:33:03.479761+00:00,20,0,0,20,0,20,29,21,20,9,1,30
10.1016/j.jsams.2014.01.004,25,28,CompositeAPI,2025-07-02T19:33:06.651596+00:00,25,0,0,25,0,25,27,26,25,2,1,28
10.1037/dev0000399,73,65,CompositeAPI,2025-07-02T19:33:09.853146+00:00,73,0,0,73,0,73,59,41,35,24,6,65
10.1080/08838159209364182,10,17,CompositeAPI,2025-07-02T19:33:16.540767+00:00,10,0,0,10,0,10,11,17,11,0,6,17
10.1016/j.ypmed.2014.08.028,51,197,CompositeAPI,2025-07-02T19:33:19.567954+00:00,51,0,0,51,0,51,191,167,161,30,6,197
10.3390/ijerph18094522,139,30,CompositeAPI,2025-07-02T19:33:26.358873+00:00,127,129,117,10,12,139,29,19,18,11,1,30
10.1080/08997764.2021.1918698,43,3,CompositeAPI,2025-07-02T19:33:34.518762+00:00,43,0,0,43,0,43,2,1,0,2,1,3
10.1093/jcmc/zmz013,60,243,CompositeAPI,2025-07-02T19:33:38.559820+00:00,60,0,0,60,0,60,243,0,0,243,0,243
10.1016/j.sleh.2021.05.009,40,19,CompositeAPI,2025-07-02T19:33:45.677433+00:00,40,0,0,40,0,40,18,16,15,3,1,19
10.1177/0735633117707792,35,5,CompositeAPI,2025-07-02T19:33:50.028924+00:00,35,0,0,35,0,35,5,5,5,0,0,5
10.1007/s41105-021-00345-6,39,8,CompositeAPI,2025-07-02T19:33:54.166678+00:00,39,0,0,39,0,39,8,7,7,1,0,8
10.3390/ijerph17197122,40,10,CompositeAPI,2025-07-02T19:33:58.137936+00:00,37,38,35,2,3,40,8,9,7,1,2,10
10.1080/00222216.2012.11950252,42,62,CompositeAPI,2025-07-02T19:34:02.156579+00:00,42,0,0,42,0,42,58,49,45,13,4,62
10.1177/1461444805049139,27,16,CompositeAPI,2025-07-02T19:34:07.111276+00:00,27,0,0,27,0,27,16,15,15,1,0,16
10.17269/s41997-019-00289-y,28,47,CompositeAPI,2025-07-02T19:34:10.982935+00:00,26,27,25,1,2,28,46,35,34,12,1,47
10.1016/j.chb.2012.12.022,73,208,CompositeAPI,2025-07-02T19:34:15.220130+00:00,73,0,0,73,0,73,200,173,165,35,8,208
10.1080/03004430601119851,31,31,CompositeAPI,2025-07-02T19:34:23.110376+00:00,31,0,0,31,0,31,28,25,22,6,3,31
10.1080/0144929x.2019.1634762,65,9,CompositeAPI,2025-07-02T19:34:27.345948+00:00,65,0,0,65,0,65,8,7,6,2,1,9
10.1016/j.copsyc.2021.12.008,46,65,CompositeAPI,2025-07-02T19:34:32.385037+00:00,46,0,0,46,0,46,64,47,46,18,1,65
10.1207/s15327825mcs0603_3,24,4,CompositeAPI,2025-07-02T19:34:36.710013+00:00,24,0,0,24,0,24,3,3,2,1,1,4
10.1177/2050157914549039,62,74,CompositeAPI,2025-07-02T19:34:40.430008+00:00,62,0,0,62,0,62,70,60,56,14,4,74
10.1037/tmb0000127,0,12,CompositeAPI,2025-07-02T19:34:45.656557+00:00,0,0,0,0,0,0,9,9,6,3,3,12
10.1177/089443930001800411,8,127,CompositeAPI,2025-07-02T19:34:48.430888+00:00,8,0,0,8,0,8,122,104,99,23,5,127
10.1080/16138171.2020.1792072,32,15,CompositeAPI,2025-07-02T19:34:52.435278+00:00,32,0,0,32,0,32,15,12,12,3,0,15
10.1176/appi.prcp.20190015,63,174,CompositeAPI,2025-07-02T19:34:56.448321+00:00,63,61,61,2,0,63,166,142,134,32,8,174
10.1177/1461444818804775,29,77,CompositeAPI,2025-07-02T19:35:02.555670+00:00,29,0,0,29,0,29,73,56,52,21,4,77
10.1080/00140139.2013.820843,63,26,CompositeAPI,2025-07-02T19:35:06.758449+00:00,63,0,0,63,0,63,26,21,21,5,0,26
10.3389/fpsyg.2021.707667,71,29,CompositeAPI,2025-07-02T19:35:13.002434+00:00,67,65,61,6,4,71,25,24,20,5,4,29
10.1080/1369118x.2017.1414865,21,17,CompositeAPI,2025-07-02T19:35:18.245565+00:00,21,0,0,21,0,21,14,12,9,5,3,17
10.1177/1461444817737296,39,39,CompositeAPI,2025-07-02T19:35:22.309329+00:00,39,0,0,39,0,39,38,28,27,11,1,39
10.3389/fpsyg.2023.1094196,51,2,CompositeAPI,2025-07-02T19:35:26.430418+00:00,48,50,47,1,3,51,2,2,2,0,0,2
10.1016/j.chb.2021.106893,44,183,CompositeAPI,2025-07-02T19:35:30.419047+00:00,44,0,0,44,0,44,163,154,134,29,20,183
10.1002/jad.12376,76,2,CompositeAPI,2025-07-02T19:35:35.622194+00:00,76,0,0,76,0,76,2,2,2,0,0,2
10.1007/s11205-025-03523-y,37,0,CompositeAPI,2025-07-02T19:35:41.508390+00:00,37,0,0,37,0,37,0,0,0,0,0,0
10.3389/fpsyt.2022.809745,124,4,CompositeAPI,2025-07-02T19:35:43.946612+00:00,106,118,100,6,18,124,4,4,4,0,0,4
10.1080/15289168.2011.614190,5,3,CompositeAPI,2025-07-02T19:35:50.942646+00:00,5,0,0,5,0,5,2,3,2,0,1,3
10.1186/1471-2458-9-212,64,8,CompositeAPI,2025-07-02T19:35:53.833963+00:00,64,0,0,64,0,64,8,0,0,8,0,8
10.1177/019251383004002008,41,11,CompositeAPI,2025-07-02T19:35:59.181658+00:00,41,0,0,41,0,41,11,8,8,3,0,11
10.1080/1369118x.2016.1164741,33,82,CompositeAPI,2025-07-02T19:36:03.963157+00:00,33,0,0,33,0,33,79,57,54,25,3,82
10.1111/j.1083-6101.2009.01451.x,46,276,CompositeAPI,2025-07-02T19:36:08.288014+00:00,46,0,0,46,0,46,259,230,213,46,17,276
10.1186/s40359-021-00582-x,55,58,CompositeAPI,2025-07-02T19:36:15.004293+00:00,55,0,0,55,0,55,56,30,28,28,2,58
10.1371/journal.pmed.1003212,47,55,CompositeAPI,2025-07-02T19:36:20.164177+00:00,45,47,45,0,2,47,52,47,44,8,3,55
10.1093/jcmc/zmy011,46,6,CompositeAPI,2025-07-02T19:36:24.396023+00:00,46,0,0,46,0,46,6,4,4,2,0,6
10.1080/15205436.2018.1490434,30,147,CompositeAPI,2025-07-02T19:36:29.388781+00:00,30,0,0,30,0,30,136,109,98,38,11,147
2394618024,0,1,CompositeAPI,2025-07-02T19:36:34.220673+00:00,0,0,0,0,0,0,0,1,0,0,1,1
10.1186/s12889-018-5674-4,39,33,CompositeAPI,2025-07-02T19:36:35.621246+00:00,37,36,34,3,2,39,33,22,22,11,0,33
10.1093/sleep/zsaa158,61,18,CompositeAPI,2025-07-02T19:36:39.856974+00:00,61,0,0,61,0,61,18,17,17,1,0,18
10.1177/0022002185016003002,24,14,CompositeAPI,2025-07-02T19:36:45.000887+00:00,24,0,0,24,0,24,12,14,12,0,2,14
10.1111/hcre.12081,83,59,CompositeAPI,2025-07-02T19:36:48.890036+00:00,83,0,0,83,0,83,59,46,46,13,0,59
10.1016/j.envres.2018.10.036,37,110,CompositeAPI,2025-07-02T19:36:55.503957+00:00,37,0,0,37,0,37,108,83,81,27,2,110
10.1037/026968,0,0,CompositeAPI,2025-07-02T19:37:00.567041+00:00,0,0,0,0,0,0,0,0,0,0,0,0
10.1111/dar.13685,52,12,CompositeAPI,2025-07-02T19:37:01.783279+00:00,51,46,45,6,1,52,10,10,8,2,2,12
10.1016/j.rasd.2023.102253,26,7,CompositeAPI,2025-07-02T19:37:09.904688+00:00,26,25,25,1,0,26,7,5,5,2,0,7
10.1016/j.pcl.2024.08.002,53,1,CompositeAPI,2025-07-02T19:37:13.892480+00:00,53,0,0,53,0,53,1,0,0,1,0,1
10.1177/08862605231192584,23,2,CompositeAPI,2025-07-02T19:37:18.815601+00:00,23,0,0,23,0,23,2,2,2,0,0,2
10.1111/sjop.12467,30,16,CompositeAPI,2025-07-02T19:37:21.842550+00:00,30,0,0,30,0,30,15,12,11,4,1,16
10.1080/17482798.2024.2358947,41,0,CompositeAPI,2025-07-02T19:37:25.968784+00:00,36,38,33,3,5,41,0,0,0,0,0,0
10.31820/pt.33.1.2,48,0,CompositeAPI,2025-07-02T19:37:32.507176+00:00,47,43,42,5,1,48,0,0,0,0,0,0
10.1123/pes.20.4.446,0,127,CompositeAPI,2025-07-02T19:37:35.090895+00:00,0,0,0,0,0,0,120,112,105,15,7,127
10.1093/pch/12.8.698,30,5,CompositeAPI,2025-07-02T19:37:38.919200+00:00,30,0,0,30,0,30,5,5,5,0,0,5
10.1016/j.chb.2024.108138,131,6,CompositeAPI,2025-07-02T19:37:42.938583+00:00,119,115,103,16,12,131,4,6,4,0,2,6
10.1177/0002764209331542,26,35,CompositeAPI,2025-07-02T19:37:50.004290+00:00,26,0,0,26,0,26,35,33,33,2,0,35
10.1177/1461444810363452,34,213,CompositeAPI,2025-07-02T19:37:54.418536+00:00,34,0,0,34,0,34,201,153,141,60,12,213
10.1542/peds.2011-1066,116,335,CompositeAPI,2025-07-02T19:38:00.299715+00:00,116,0,0,116,0,116,315,277,257,58,20,335
10.3390/ijerph20043771,59,6,CompositeAPI,2025-07-02T19:38:11.207196+00:00,56,58,55,1,3,59,5,6,5,0,1,6
10.1080/13691180701307461,39,56,CompositeAPI,2025-07-02T19:38:16.221609+00:00,39,0,0,39,0,39,48,51,43,5,8,56
10.1111/bjdp.12429,66,24,CompositeAPI,2025-07-02T19:38:20.353665+00:00,66,0,0,66,0,66,21,21,18,3,3,24
10.4018/ijcbpl.2016100101,25,16,CompositeAPI,2025-07-02T19:38:25.443388+00:00,25,0,0,25,0,25,13,14,11,2,3,16
10.1080/09546553.2021.1908270,0,2,CompositeAPI,2025-07-02T19:38:29.503789+00:00,0,0,0,0,0,0,2,2,2,0,0,2
10.1177/0956797610362670,29,120,CompositeAPI,2025-07-02T19:38:32.139687+00:00,29,0,0,29,0,29,107,96,83,24,13,120
10.1123/jpah.2023-0346,72,11,CompositeAPI,2025-07-02T19:38:37.172785+00:00,72,0,0,72,0,72,10,9,8,2,1,11
10.1007/s11205-008-9414-5,6,8,CompositeAPI,2025-07-02T19:38:42.443707+00:00,6,0,0,6,0,6,8,6,6,2,0,8
10.1016/j.techfore.2017.06.023,114,67,CompositeAPI,2025-07-02T19:38:45.619561+00:00,114,0,0,114,0,114,61,56,50,11,6,67
10.4278/0890-1171-21.4s.353,60,57,CompositeAPI,2025-07-02T19:38:52.715335+00:00,60,0,0,60,0,60,57,0,0,57,0,57
10.1111/%28issn%291651-2227,0,0,CompositeAPI,2025-07-02T19:38:58.260505+00:00,0,0,0,0,0,0,0,0,0,0,0,0
10.1186/s12889-021-11802-9,32,66,CompositeAPI,2025-07-02T19:38:59.518178+00:00,30,29,27,3,2,32,58,54,46,12,8,66
10.1016/j.comppsych.2024.152452,52,10,CompositeAPI,2025-07-02T19:39:04.090038+00:00,50,44,42,8,2,52,10,7,7,3,0,10
10.1007/s12564-010-9127-8,37,4,CompositeAPI,2025-07-02T19:39:08.245212+00:00,37,0,0,37,0,37,3,4,3,0,1,4
10.1016/j.chb.2020.106355,70,12,CompositeAPI,2025-07-02T19:39:12.454933+00:00,66,66,62,4,4,70,12,8,8,4,0,12
2388919292,28,35,CompositeAPI,2025-07-02T19:39:17.524122+00:00,28,0,0,28,0,28,14,31,10,4,21,35
10.1016/j.amepre.2007.07.009,27,123,CompositeAPI,2025-07-02T19:39:21.722151+00:00,27,0,0,27,0,27,117,117,111,6,6,123
10.1016/j.chb.2015.05.026,31,113,CompositeAPI,2025-07-02T19:39:26.700583+00:00,31,0,0,31,0,31,107,88,82,25,6,113
10.1177/1461444820932556,67,12,CompositeAPI,2025-07-02T19:39:31.636329+00:00,67,0,0,67,0,67,12,9,9,3,0,12
10.1089/cpb.2006.9939,35,111,CompositeAPI,2025-07-02T19:39:36.619844+00:00,35,0,0,35,0,35,102,91,82,20,9,111
10.1080/08838151.2019.1689072,45,15,CompositeAPI,2025-07-02T19:39:41.828822+00:00,45,0,0,45,0,45,14,11,10,4,1,15
10.1177/001100008100900412,17,1,CompositeAPI,2025-07-02T19:39:45.989773+00:00,17,0,0,17,0,17,0,1,0,0,1,1
10.1016/j.telpol.2003.07.001,8,140,CompositeAPI,2025-07-02T19:39:47.441234+00:00,8,0,0,8,0,8,131,117,108,23,9,140
10.2196/43388,68,38,CompositeAPI,2025-07-02T19:39:51.535531+00:00,64,61,57,7,4,68,33,24,19,14,5,38
10.1371/journal.pone.0024453,73,95,CompositeAPI,2025-07-02T19:39:56.817042+00:00,69,69,65,4,4,73,90,82,77,13,5,95
10.1001/jamapediatrics.2022.4793,66,41,CompositeAPI,2025-07-02T19:40:02.336789+00:00,66,0,0,66,0,66,40,30,29,11,1,41
10.3390/ijerph16122078,32,100,CompositeAPI,2025-07-02T19:40:07.608002+00:00,32,30,30,2,0,32,98,82,80,18,2,100
10.1515/bejeap-2015-0094,35,27,CompositeAPI,2025-07-02T19:40:11.911064+00:00,35,0,0,35,0,35,12,23,8,4,15,27
10.1177/2055207619844870,37,18,CompositeAPI,2025-07-02T19:40:15.937351+00:00,37,36,36,1,0,37,17,15,14,3,1,18
10.1177/0093650208315979,23,151,CompositeAPI,2025-07-02T19:40:20.133246+00:00,23,0,0,23,0,23,148,108,105,43,3,151
10.1080/10410236.2017.1422103,26,26,CompositeAPI,2025-07-02T19:40:25.083646+00:00,26,0,0,26,0,26,25,23,22,3,1,26
10.1002/9781444302752.ch16,74,7,CompositeAPI,2025-07-02T19:40:29.544612+00:00,74,0,0,74,0,74,6,6,5,1,1,7
10.1016/b978-0-12-817319-0.00010-4,28,2,CompositeAPI,2025-07-02T19:40:35.512822+00:00,28,0,0,28,0,28,1,2,1,0,1,2
10.1111/j.1083-6101.2006.tb00314.x,41,28,CompositeAPI,2025-07-02T19:40:39.529667+00:00,41,0,0,41,0,41,28,24,24,4,0,28
10.1007/s10648-017-9430-6,91,79,CompositeAPI,2025-07-02T19:40:44.092595+00:00,91,0,0,91,0,91,79,0,0,79,0,79
10.1002/soej.12537,16,2,CompositeAPI,2025-07-02T19:40:51.462181+00:00,16,0,0,16,0,16,2,1,1,1,0,2
10.1007/s11205-008-9285-9,18,34,CompositeAPI,2025-07-02T19:40:54.506275+00:00,18,0,0,18,0,18,33,28,27,6,1,34
10.1371/journal.pgph.0004262,60,3,CompositeAPI,2025-07-02T19:40:58.525062+00:00,57,58,55,2,3,60,3,3,3,0,0,3
10.47009/jamp.2023.5.1.149,0,0,CompositeAPI,2025-07-02T19:41:03.534750+00:00,0,0,0,0,0,0,0,0,0,0,0,0
10.1542/peds.2017-2674,6,8,CompositeAPI,2025-07-02T19:41:04.577127+00:00,6,0,0,6,0,6,8,7,7,1,0,8
10.1353/sof.2003.0086,12,123,CompositeAPI,2025-07-02T19:41:07.568188+00:00,12,0,0,12,0,12,115,99,91,24,8,123
10.1016/j.sbspro.2011.10.239,8,9,CompositeAPI,2025-07-02T19:41:12.329679+00:00,8,7,7,1,0,8,9,5,5,4,0,9
10.1073/pnas.1908630116,28,350,CompositeAPI,2025-07-02T19:41:15.268392+00:00,28,0,0,28,0,28,330,214,194,136,20,350
10.1177/0093650210377196,66,208,CompositeAPI,2025-07-02T19:41:21.879605+00:00,66,0,0,66,0,66,198,177,167,31,10,208
10.1006/drev.1994.1002,0,29,CompositeAPI,2025-07-02T19:41:28.802150+00:00,0,0,0,0,0,0,27,21,19,8,2,29
10.1080/17482798.2011.633404,46,77,CompositeAPI,2025-07-02T19:41:31.660116+00:00,46,0,0,46,0,46,71,69,63,8,6,77
10.1177/0267323113476990e,5,28,CompositeAPI,2025-07-02T19:41:35.966061+00:00,5,0,0,5,0,5,27,2,1,26,1,28
10.1016/j.jpubeco.2023.105031,44,5,CompositeAPI,2025-07-02T19:41:39.092455+00:00,36,36,28,8,8,44,3,5,3,0,2,5
10.1016/j.telpol.2012.09.008,36,28,CompositeAPI,2025-07-02T19:41:43.102717+00:00,36,0,0,36,0,36,27,27,26,1,1,28
10.3390/biology11010111,38,7,CompositeAPI,2025-07-02T19:41:47.601529+00:00,36,35,33,3,2,38,7,7,7,0,0,7
10.1016/j.appet.2017.08.018,49,36,CompositeAPI,2025-07-02T19:41:55.050600+00:00,49,0,0,49,0,49,36,30,30,6,0,36
10.1186/s12889-022-14459-0,57,14,CompositeAPI,2025-07-02T19:41:59.223648+00:00,53,53,49,4,4,57,14,11,11,3,0,14
3043600907,0,7,CompositeAPI,2025-07-02T19:42:04.314672+00:00,0,0,0,0,0,0,4,5,2,2,3,7
10.1016/j.chb.2016.04.043,74,225,CompositeAPI,2025-07-02T19:42:07.108860+00:00,74,0,0,74,0,74,213,185,173,40,12,225
10.1177/1555412005281915,5,23,CompositeAPI,2025-07-02T19:42:16.986009+00:00,5,0,0,5,0,5,21,20,18,3,2,23
10.1111/1540-5834.00120,126,471,CompositeAPI,2025-07-02T19:42:20.610245+00:00,126,0,0,126,0,126,382,450,361,21,89,471
2126311508,26,107,CompositeAPI,2025-07-02T19:42:32.802265+00:00,26,0,0,26,0,26,82,93,68,14,25,107
10.1016/j.numecd.2007.07.008,110,525,CompositeAPI,2025-07-02T19:42:37.993350+00:00,110,0,0,110,0,110,500,478,453,47,25,525
10.1177/15270025221085714,17,5,CompositeAPI,2025-07-02T19:42:49.465703+00:00,16,15,14,2,1,17,4,5,4,0,1,5
10.4324/9781351130912-5,1,0,CompositeAPI,2025-07-02T19:42:52.391806+00:00,1,0,0,1,0,1,0,0,0,0,0,0
10.1016/j.lisr.2017.07.002,33,9,CompositeAPI,2025-07-02T19:42:53.744735+00:00,33,0,0,33,0,33,9,7,7,2,0,9
10.1007/s10826-022-02252-x,34,7,CompositeAPI,2025-07-02T19:42:57.796947+00:00,26,32,24,2,8,34,7,6,6,1,0,7
10.1007/s10803-017-3201-6,30,87,CompositeAPI,2025-07-02T19:43:01.717147+00:00,30,0,0,30,0,30,84,61,58,26,3,87
10.1177/08944393241235182,42,1,CompositeAPI,2025-07-02T19:43:05.983623+00:00,39,38,35,4,3,42,1,1,1,0,0,1
10.1016/j.aap.2019.04.017,44,51,CompositeAPI,2025-07-02T19:43:13.047168+00:00,44,0,0,44,0,44,50,44,43,7,1,51
10.17576/jkmjc-2017-3303-15,38,16,CompositeAPI,2025-07-02T19:43:18.321770+00:00,38,0,0,38,0,38,11,12,7,4,5,16
10.1186/1479-5868-11-46,19,34,CompositeAPI,2025-07-02T19:43:22.324769+00:00,18,15,14,4,1,19,32,29,27,5,2,34
10.1016/j.copsyc.2022.101339,38,85,CompositeAPI,2025-07-02T19:43:25.553181+00:00,38,0,0,38,0,38,82,62,59,23,3,85
10.1016/s1728-869x(09)60020-4,42,5,CompositeAPI,2025-07-02T19:43:29.948262+00:00,40,38,36,4,2,42,5,5,5,0,0,5
10.1001/jamapediatrics.2019.1759,43,372,CompositeAPI,2025-07-02T19:43:34.304683+00:00,43,0,0,43,0,43,361,297,286,75,11,372
10.1016/j.tele.2012.02.002,44,27,CompositeAPI,2025-07-02T19:43:41.194711+00:00,44,0,0,44,0,44,26,24,23,3,1,27
10.51866/rv1143,36,41,CompositeAPI,2025-07-02T19:43:45.349209+00:00,34,31,29,5,2,36,39,17,15,24,2,41
10.1108/dpm-04-2019-0125,19,1,CompositeAPI,2025-07-02T19:43:49.526627+00:00,19,0,0,19,0,19,1,0,0,1,0,1
10.1016/j.chb.2017.01.051,59,170,CompositeAPI,2025-07-02T19:43:52.453128+00:00,59,0,0,59,0,59,163,133,126,37,7,170
10.1353/cj.2016.0004,0,0,CompositeAPI,2025-07-02T19:43:58.562675+00:00,0,0,0,0,0,0,0,0,0,0,0,0
10.1177/15270025241240393,29,0,CompositeAPI,2025-07-02T19:44:00.002156+00:00,29,0,0,29,0,29,0,0,0,0,0,0
10.1249/mss.0000000000001002,33,50,CompositeAPI,2025-07-02T19:44:02.461801+00:00,33,0,0,33,0,33,50,40,40,10,0,50
10.1146/annurev.soc.27.1.307,116,1724,CompositeAPI,2025-07-02T19:44:06.727286+00:00,116,0,0,116,0,116,1627,1345,1248,379,97,1724
10.1016/j.infoecopol.2016.01.003,36,98,CompositeAPI,2025-07-02T19:44:30.722531+00:00,36,0,0,36,0,36,98,0,0,98,0,98
10.1177/0894439309334815,17,11,CompositeAPI,2025-07-02T19:44:35.750656+00:00,17,0,0,17,0,17,11,10,10,1,0,11
10.4018/978-1-4666-0315-8.ch026,35,18,CompositeAPI,2025-07-02T19:44:38.788523+00:00,35,0,0,35,0,35,18,0,0,18,0,18
10.1186/1479-5868-7-46,38,191,CompositeAPI,2025-07-02T19:44:42.906693+00:00,37,36,35,2,1,38,180,172,161,19,11,191
10.1016/j.pcl.2024.07.032,70,0,CompositeAPI,2025-07-02T19:44:48.498017+00:00,70,0,0,70,0,70,0,0,0,0,0,0
10.1016/s0148-2963(96)00067-7,22,71,CompositeAPI,2025-07-02T19:44:52.063890+00:00,22,0,0,22,0,22,66,57,52,14,5,71
10.1080/13504851.2018.1528331,13,3,CompositeAPI,2025-07-02T19:44:56.117340+00:00,13,0,0,13,0,13,3,3,3,0,0,3
10.1177/1527002518762551,25,25,CompositeAPI,2025-07-02T19:44:59.009674+00:00,25,0,0,25,0,25,21,21,17,4,4,25
10.1023/a:1006883609105,2,11,CompositeAPI,2025-07-02T19:45:03.100606+00:00,2,0,0,2,0,2,9,9,7,2,2,11
10.1353/foc.0.0000,12,334,CompositeAPI,2025-07-02T19:45:06.456172+00:00,12,0,0,12,0,12,283,300,249,34,51,334
10.1016/j.cjca.2020.04.015,58,6,CompositeAPI,2025-07-02T19:45:12.644020+00:00,58,0,0,58,0,58,5,5,4,1,1,6
10.1001/archpedi.1991.02160090086030,11,110,CompositeAPI,2025-07-02T19:45:17.606605+00:00,11,0,0,11,0,11,100,97,87,13,10,110
10.1186/1479-5868-8-90,44,44,CompositeAPI,2025-07-02T19:45:21.502317+00:00,43,40,39,4,1,44,40,41,37,3,4,44
10.1016/j.smrv.2024.102025,10,1,CompositeAPI,2025-07-02T19:45:25.711645+00:00,10,0,0,10,0,10,1,1,1,0,0,1
10.1177/089443939901700207,4,60,CompositeAPI,2025-07-02T19:45:28.660290+00:00,4,0,0,4,0,4,54,47,41,13,6,60
10.1007/s40279-022-01682-3,60,8,CompositeAPI,2025-07-02T19:45:31.912289+00:00,60,0,0,60,0,60,7,7,6,1,1,8
10.1111/jcc4.12091,34,59,CompositeAPI,2025-07-02T19:45:37.088319+00:00,34,0,0,34,0,34,58,56,55,3,1,59
10.1080/15213269.2024.2400571,57,0,CompositeAPI,2025-07-02T19:45:41.305328+00:00,57,0,0,57,0,57,0,0,0,0,0,0
10.1016/j.chb.2020.106550,60,73,CompositeAPI,2025-07-02T19:45:44.686329+00:00,55,51,46,9,5,60,71,49,47,24,2,73
10.1111/j.1475-682x.1997.tb00432.x,20,11,CompositeAPI,2025-07-02T19:45:49.861873+00:00,20,0,0,20,0,20,10,8,7,3,1,11
10.1177/2167702619898179,27,11,CompositeAPI,2025-07-02T19:45:53.053439+00:00,27,0,0,27,0,27,10,7,6,4,1,11
10.1080/15213269.2016.1257393,55,55,CompositeAPI,2025-07-02T19:45:56.956489+00:00,55,0,0,55,0,55,51,47,43,8,4,55
10.1096/fasebj.26.1_supplement.1011.5,0,0,CompositeAPI,2025-07-02T19:46:02.150671+00:00,0,0,0,0,0,0,0,0,0,0,0,0
10.1542/peds.2016-1758j,31,327,CompositeAPI,2025-07-02T19:46:03.422773+00:00,31,0,0,31,0,31,312,241,226,86,15,327
10.1111/j.1365-277x.2006.00683.x,26,46,CompositeAPI,2025-07-02T19:46:09.971671+00:00,26,0,0,26,0,26,45,33,32,13,1,46
10.1016/j.mhpa.2020.100380,40,39,CompositeAPI,2025-07-02T19:46:14.118430+00:00,40,0,0,40,0,40,38,29,28,10,1,39
10.1016/j.infoecopol.2012.08.002,10,112,CompositeAPI,2025-07-02T19:46:18.497527+00:00,10,0,0,10,0,10,105,63,56,49,7,112
10.1080/23311886.2022.2042113,35,5,CompositeAPI,2025-07-02T19:46:22.348654+00:00,34,34,33,1,1,35,4,3,2,2,1,5
10.1016/j.infoecopol.2021.100927,23,8,CompositeAPI,2025-07-02T19:46:26.364530+00:00,23,0,0,23,0,23,7,5,4,3,1,8
10.21659/rupkatha.v8n4.11,3,1,CompositeAPI,2025-07-02T19:46:30.570503+00:00,1,2,0,1,2,3,1,0,0,1,0,1
10.1080/10720530290100433,12,15,CompositeAPI,2025-07-02T19:46:33.400347+00:00,12,0,0,12,0,12,15,9,9,6,0,15
10.17323/1813-8918-2023-1-62-70,19,2,CompositeAPI,2025-07-02T19:46:36.611388+00:00,19,0,0,19,0,19,2,0,0,2,0,2
10.1207/s15327736me1701_2,18,364,CompositeAPI,2025-07-02T19:46:39.775798+00:00,18,0,0,18,0,18,337,297,270,67,27,364
10.1016/j.tele.2015.06.014,38,89,CompositeAPI,2025-07-02T19:46:46.146801+00:00,38,0,0,38,0,38,85,77,73,12,4,89
10.1177/14614448241301741,59,3,CompositeAPI,2025-07-02T19:46:50.355630+00:00,59,0,0,59,0,59,1,3,1,0,2,3
10.1089/1094931041291303,17,400,CompositeAPI,2025-07-02T19:47:04.692456+00:00,17,0,0,17,0,17,367,340,307,60,33,400
10.1111/j.1083-6101.2007.00368.x,50,644,CompositeAPI,2025-07-02T19:47:12.294612+00:00,50,0,0,50,0,50,608,545,509,99,36,644
10.1123/jpah.6.3.299,0,14,CompositeAPI,2025-07-02T19:47:22.269287+00:00,0,0,0,0,0,0,12,14,12,0,2,14
10.1108/sbm-08-2020-0080,74,5,CompositeAPI,2025-07-02T19:47:26.191240+00:00,74,0,0,74,0,74,5,3,3,2,0,5
10.3305/nh.2013.28.sup5.6924,28,42,CompositeAPI,2025-07-02T19:47:32.656161+00:00,28,0,0,28,0,28,38,37,33,5,4,42
10.1007/s11469-013-9461-2,52,76,CompositeAPI,2025-07-02T19:47:36.890538+00:00,52,0,0,52,0,52,70,63,57,13,6,76
10.1371/journal.pone.0142544,39,42,CompositeAPI,2025-07-02T19:47:41.987735+00:00,38,34,33,5,1,39,36,41,35,1,6,42
10.3390/su12062554,24,17,CompositeAPI,2025-07-02T19:47:46.121945+00:00,24,0,0,24,0,24,17,0,0,17,0,17
10.1016/j.ypmed.2016.08.033,64,26,CompositeAPI,2025-07-02T19:47:50.138271+00:00,62,55,53,9,2,64,24,23,21,3,2,26
10.3389/fpsyg.2020.02224,57,32,CompositeAPI,2025-07-02T19:47:55.671565+00:00,51,53,47,4,6,57,31,23,22,9,1,32
10.1016/j.geoforum.2019.02.010,74,59,CompositeAPI,2025-07-02T19:48:00.614509+00:00,74,0,0,74,0,74,57,42,40,17,2,59
3138176270,15,8,CompositeAPI,2025-07-02T19:48:06.688163+00:00,15,0,0,15,0,15,8,0,0,8,0,8
10.1016/j.crbeha.2023.100140,70,9,CompositeAPI,2025-07-02T19:48:10.046017+00:00,66,65,61,5,4,70,8,8,7,1,1,9
10.1080/15389588.2015.1020422,29,14,CompositeAPI,2025-07-02T19:48:15.169552+00:00,22,25,18,4,7,29,13,13,12,1,1,14
10.1016/s2352-4642(19)30186-5,24,259,CompositeAPI,2025-07-02T19:48:19.083175+00:00,24,0,0,24,0,24,248,180,169,79,11,259
10.1177/0267323198013004003,12,30,CompositeAPI,2025-07-02T19:48:25.332875+00:00,12,0,0,12,0,12,28,27,25,3,2,30
10.4103/jmhhb.jmhhb_165_21,32,3,CompositeAPI,2025-07-02T19:48:28.548819+00:00,32,0,0,32,0,32,3,0,0,3,0,3
10.1136/bmj.l5143,1,1,CompositeAPI,2025-07-02T19:48:32.493266+00:00,1,0,0,1,0,1,1,1,1,0,0,1
10.1002/wps.20820,7,75,CompositeAPI,2025-07-02T19:48:35.346820+00:00,7,0,0,7,0,7,73,59,57,16,2,75
10.3389/fpsyg.2023.1279893,32,1,CompositeAPI,2025-07-02T19:48:38.637971+00:00,32,32,32,0,0,32,1,1,1,0,0,1
10.1080/07448481.2022.2152690,42,7,CompositeAPI,2025-07-02T19:48:42.552401+00:00,42,0,0,42,0,42,6,5,4,2,1,7
10.1080/17482798.2020.1859396,8,3,CompositeAPI,2025-07-02T19:48:46.697023+00:00,8,0,0,8,0,8,2,2,1,1,1,3
10.1037/0012-1649.35.4.912,0,237,CompositeAPI,2025-07-02T19:48:49.627906+00:00,0,0,0,0,0,0,193,202,158,35,44,237
10.1080/08838159909364493,28,58,CompositeAPI,2025-07-02T19:48:53.467936+00:00,28,0,0,28,0,28,53,50,45,8,5,58
10.1177/1461444809341859,58,101,CompositeAPI,2025-07-02T19:48:57.863278+00:00,58,0,0,58,0,58,96,90,85,11,5,101
10.1080/13229400.2022.2040575,25,17,CompositeAPI,2025-07-02T19:49:03.810329+00:00,21,23,19,2,4,25,15,12,10,5,2,17
10.1370/afm.1976,15,148,CompositeAPI,2025-07-02T19:49:06.889020+00:00,15,11,11,4,0,15,141,109,102,39,7,148
10.1007/s10639-023-11638-3,31,7,CompositeAPI,2025-07-02T19:49:11.234368+00:00,31,0,0,31,0,31,7,7,7,0,0,7
10.1080/17461391.2018.1548649,43,40,CompositeAPI,2025-07-02T19:49:15.241721+00:00,43,0,0,43,0,43,39,30,29,10,1,40
