doi,references_found,citations_found,api,retrieval_timestamp,references_OpenAlex,references_SemanticScholar,references_Overlap,references_OpenAlex_unique,references_SemanticScholar_unique,references_Total_unique,citations_OpenAlex,citations_SemanticScholar,citations_Overlap,citations_OpenAlex_unique,citations_SemanticScholar_unique,citations_Total_unique
10.3390/ijerph18094522,139,30,CompositeAPI,2025-07-02T14:51:29.039909+00:00,127,129,117,10,12,139,29,19,18,11,1,30
10.1515/bejeap-2015-0094,35,27,CompositeAPI,2025-07-02T14:51:37.222465+00:00,35,0,0,35,0,35,12,23,8,4,15,27
10.1027/1864-1105/a000388,59,6,CompositeAPI,2025-07-02T14:51:41.252590+00:00,59,0,0,59,0,59,6,4,4,2,0,6
10.1177/1461444820932556,67,12,CompositeAPI,2025-07-02T14:51:46.288886+00:00,67,0,0,67,0,67,12,9,9,3,0,12
10.1080/17482798.2011.633404,46,77,CompositeAPI,2025-07-02T14:51:51.354145+00:00,46,0,0,46,0,46,71,69,63,8,6,77
10.1016/j.adolescence.2010.11.009,31,21,CompositeAPI,2025-07-02T14:51:55.626370+00:00,31,0,0,31,0,31,20,18,17,3,1,21
10.1093/oxfordhb/9780195393002.013.0024,0,1,CompositeAPI,2025-07-02T14:51:59.638452+00:00,0,0,0,0,0,0,1,0,0,1,0,1
10.1016/j.ypmed.2014.08.028,51,197,CompositeAPI,2025-07-02T14:52:02.288108+00:00,51,0,0,51,0,51,191,167,161,30,6,197
10.1080/10810730.2020.1746868,57,30,CompositeAPI,2025-07-02T14:52:08.931047+00:00,57,0,0,57,0,57,30,25,25,5,0,30
10.1177/089443938800600204,18,39,CompositeAPI,2025-07-02T14:52:14.136708+00:00,18,0,0,18,0,18,33,25,19,14,6,39
10.1080/17482798.2020.1859396,8,3,CompositeAPI,2025-07-02T14:52:17.260608+00:00,8,0,0,8,0,8,2,2,1,1,1,3
10.1093/sleep/zsaa158,61,18,CompositeAPI,2025-07-02T14:52:20.176221+00:00,61,0,0,61,0,61,18,17,17,1,0,18
10.1001/archpedi.1991.02160090086030,11,110,CompositeAPI,2025-07-02T14:52:25.251851+00:00,11,0,0,11,0,11,100,97,87,13,10,110
10.1007/s11205-010-9653-0,31,18,CompositeAPI,2025-07-02T14:52:29.197585+00:00,24,24,17,7,7,31,16,12,10,6,2,18
10.1016/j.chb.2021.106893,44,183,CompositeAPI,2025-07-02T14:52:33.394127+00:00,44,0,0,44,0,44,163,154,134,29,20,183
10.1177/15270025221085714,17,5,CompositeAPI,2025-07-02T14:52:38.685944+00:00,16,15,14,2,1,17,4,5,4,0,1,5
10.1177/009365093020001003,30,153,CompositeAPI,2025-07-02T14:52:41.746716+00:00,30,0,0,30,0,30,147,108,102,45,6,153
10.1016/j.pcl.2024.08.002,53,1,CompositeAPI,2025-07-02T14:52:46.719776+00:00,53,0,0,53,0,53,1,0,0,1,0,1
10.3316/informit.414140549600484,0,0,CompositeAPI,2025-07-02T14:52:51.740409+00:00,0,0,0,0,0,0,0,0,0,0,0,0
10.1186/s12889-022-14459-0,57,14,CompositeAPI,2025-07-02T14:52:52.782861+00:00,53,53,49,4,4,57,14,11,11,3,0,14
10.1006/drev.1994.1002,0,29,CompositeAPI,2025-07-02T14:52:57.733750+00:00,0,0,0,0,0,0,27,21,19,8,2,29
10.2196/57198,24,0,CompositeAPI,2025-07-02T14:53:00.539563+00:00,23,24,23,0,1,24,0,0,0,0,0,0
10.3390/ijerph16122078,32,100,CompositeAPI,2025-07-02T14:53:02.148701+00:00,32,30,30,2,0,32,98,82,80,18,2,100
10.1016/j.infoecopol.2012.08.002,10,112,CompositeAPI,2025-07-02T14:53:06.397817+00:00,10,0,0,10,0,10,105,63,56,49,7,112
10.1016/j.chc.2005.03.001,54,23,CompositeAPI,2025-07-02T14:53:10.403123+00:00,54,0,0,54,0,54,18,21,16,2,5,23
10.1177/000494419303700207,27,18,CompositeAPI,2025-07-02T14:53:15.807561+00:00,27,0,0,27,0,27,17,17,16,1,1,18
10.1136/bmj.l5143,1,1,CompositeAPI,2025-07-02T14:53:19.821394+00:00,1,0,0,1,0,1,1,1,1,0,0,1
10.1016/s2352-4642(19)30186-5,24,259,CompositeAPI,2025-07-02T14:53:22.761701+00:00,24,0,0,24,0,24,248,180,169,79,11,259
10.1016/j.jaac.2019.11.023,7,1,CompositeAPI,2025-07-02T14:53:29.060246+00:00,7,0,0,7,0,7,1,1,1,0,0,1
10.3389/fhumd.2021.585906,26,1,CompositeAPI,2025-07-02T14:53:32.145748+00:00,22,25,21,1,4,26,1,0,0,1,0,1
10.1016/j.crbeha.2023.100140,70,9,CompositeAPI,2025-07-02T14:53:35.162906+00:00,66,65,61,5,4,70,8,8,7,1,1,9
10.1177/0894439309334815,17,11,CompositeAPI,2025-07-02T14:53:40.200887+00:00,17,0,0,17,0,17,11,10,10,1,0,11
10.1111/j.1083-6101.2006.tb00314.x,41,28,CompositeAPI,2025-07-02T14:53:43.237173+00:00,41,0,0,41,0,41,28,24,24,4,0,28
10.1111/j.1083-6101.2002.tb00143.x,36,56,CompositeAPI,2025-07-02T14:53:47.655055+00:00,36,0,0,36,0,36,47,50,41,6,9,56
10.1177/1463949117714080,34,10,CompositeAPI,2025-07-02T14:53:51.706223+00:00,34,0,0,34,0,34,10,9,9,1,0,10
10.1177/0022002185016003002,24,14,CompositeAPI,2025-07-02T14:53:55.754486+00:00,24,0,0,24,0,24,12,14,12,0,2,14
10.1023/a:1006883609105,2,11,CompositeAPI,2025-07-02T14:53:59.523836+00:00,2,0,0,2,0,2,9,9,7,2,2,11
10.3102/00346543051002193,30,96,CompositeAPI,2025-07-02T14:54:02.861626+00:00,30,0,0,30,0,30,89,92,85,4,7,96
10.1123/pes.20.4.446,0,127,CompositeAPI,2025-07-02T14:54:07.312226+00:00,0,0,0,0,0,0,120,112,105,15,7,127
10.1111/jcpp.13282,31,47,CompositeAPI,2025-07-02T14:54:11.205050+00:00,26,29,24,2,5,31,44,37,34,10,3,47
10.1016/j.socscimed.2019.05.030,92,56,CompositeAPI,2025-07-02T14:54:15.181222+00:00,92,0,0,92,0,92,51,39,34,17,5,56
10.1176/appi.prcp.20190015,63,174,CompositeAPI,2025-07-02T14:54:21.618961+00:00,63,61,61,2,0,63,166,142,134,32,8,174
10.1080/13691180701307461,39,56,CompositeAPI,2025-07-02T14:54:27.724697+00:00,39,0,0,39,0,39,48,51,43,5,8,56
10.1111/j.1467-9663.2008.00494.x,54,36,CompositeAPI,2025-07-02T14:54:32.000520+00:00,54,0,0,54,0,54,36,32,32,4,0,36
10.1016/j.chb.2017.01.051,59,170,CompositeAPI,2025-07-02T14:54:37.310625+00:00,59,0,0,59,0,59,163,133,126,37,7,170
10.1016/j.rpsp.2016.07.001,28,3,CompositeAPI,2025-07-02T14:54:43.246206+00:00,27,26,25,2,1,28,3,2,2,1,0,3
10.1007/s10389-019-01043-x,51,61,CompositeAPI,2025-07-02T14:54:47.112630+00:00,51,0,0,51,0,51,57,47,43,14,4,61
10.1080/15389588.2015.1020422,29,14,CompositeAPI,2025-07-02T14:54:52.639372+00:00,22,25,18,4,7,29,13,13,12,1,1,14
10.1177/1461444809356334,40,30,CompositeAPI,2025-07-02T14:54:56.539665+00:00,40,0,0,40,0,40,24,30,24,0,6,30
10.1037/dev0000851,70,51,CompositeAPI,2025-07-02T14:55:00.558683+00:00,70,0,0,70,0,70,47,39,35,12,4,51
10.1111/ijsw.70012,37,0,CompositeAPI,2025-07-02T14:55:06.690438+00:00,37,0,0,37,0,37,0,0,0,0,0,0
10.2501/jar-53-1-071-082,9,30,CompositeAPI,2025-07-02T14:55:09.359633+00:00,9,0,0,9,0,9,29,22,21,8,1,30
10.1080/14616700802337768,3,75,CompositeAPI,2025-07-02T14:55:12.581863+00:00,3,0,0,3,0,3,65,66,56,9,10,75
2943800371,0,37,CompositeAPI,2025-07-02T14:55:15.744943+00:00,0,0,0,0,0,0,28,30,21,7,9,37
10.17576/jkmjc-2017-3303-15,38,16,CompositeAPI,2025-07-02T14:55:19.147963+00:00,38,0,0,38,0,38,11,12,7,4,5,16
10.1111/j.1365-277x.2006.00683.x,26,46,CompositeAPI,2025-07-02T14:55:23.240836+00:00,26,0,0,26,0,26,45,33,32,13,1,46
10.3389/fpsyg.2023.1094196,51,2,CompositeAPI,2025-07-02T14:55:27.277368+00:00,48,50,47,1,3,51,2,2,2,0,0,2
10.1016/j.compedu.2019.103704,32,37,CompositeAPI,2025-07-02T14:55:31.331947+00:00,32,0,0,32,0,32,37,30,30,7,0,37
10.3200/gntp.165.4.367-382,20,100,CompositeAPI,2025-07-02T14:55:35.509447+00:00,20,0,0,20,0,20,92,73,65,27,8,100
10.1016/j.geoforum.2019.02.010,74,59,CompositeAPI,2025-07-02T14:55:39.553343+00:00,74,0,0,74,0,74,57,42,40,17,2,59
10.1186/s12889-021-11802-9,32,66,CompositeAPI,2025-07-02T14:55:45.796831+00:00,30,29,27,3,2,32,58,54,46,12,8,66
10.1093/acprof:oso/9780195312805.003.0012,0,13,CompositeAPI,2025-07-02T14:55:50.366194+00:00,0,0,0,0,0,0,13,3,3,10,0,13
10.47009/jamp.2023.5.1.149,0,0,CompositeAPI,2025-07-02T14:55:53.007232+00:00,0,0,0,0,0,0,0,0,0,0,0,0
10.1177/009365000027002005,32,325,CompositeAPI,2025-07-02T14:55:54.044330+00:00,32,0,0,32,0,32,310,297,282,28,15,325
10.1163/15685314-04601008,0,5,CompositeAPI,2025-07-02T14:56:00.659509+00:00,0,0,0,0,0,0,5,5,5,0,0,5
10.1016/j.envres.2018.10.036,37,110,CompositeAPI,2025-07-02T14:56:03.335617+00:00,37,0,0,37,0,37,108,83,81,27,2,110
10.1177/019251383004002008,41,11,CompositeAPI,2025-07-02T14:56:08.362902+00:00,41,0,0,41,0,41,11,8,8,3,0,11
10.1371/journal.pone.0257877,49,16,CompositeAPI,2025-07-02T14:56:13.067203+00:00,46,46,43,3,3,49,15,14,13,2,1,16
10.1002/soej.12537,16,2,CompositeAPI,2025-07-02T14:56:17.131392+00:00,16,0,0,16,0,16,2,1,1,1,0,2
10.1542/peds.2016-1758j,31,326,CompositeAPI,2025-07-02T14:56:20.065829+00:00,31,0,0,31,0,31,312,240,226,86,14,326
10.4278/0890-1171-21.4s.353,60,57,CompositeAPI,2025-07-02T14:56:26.704344+00:00,60,0,0,60,0,60,57,0,0,57,0,57
10.1017/s0021849904040073,17,44,CompositeAPI,2025-07-02T14:56:32.239820+00:00,17,0,0,17,0,17,42,38,36,6,2,44
10.1016/j.chb.2015.03.073,29,25,CompositeAPI,2025-07-02T14:56:35.551947+00:00,29,0,0,29,0,29,23,24,22,1,2,25
10.1177/1555412005281915,5,23,CompositeAPI,2025-07-02T14:56:39.457639+00:00,5,0,0,5,0,5,21,20,18,3,2,23
10.1016/j.sleh.2021.05.009,40,19,CompositeAPI,2025-07-02T14:56:42.905780+00:00,40,0,0,40,0,40,18,16,15,3,1,19
10.1016/j.jpeds.2018.09.054,28,103,CompositeAPI,2025-07-02T14:56:47.782055+00:00,28,0,0,28,0,28,96,86,79,17,7,103
10.23750/abm.v95i5.15826,0,0,CompositeAPI,2025-07-02T14:56:51.902702+00:00,0,0,0,0,0,0,0,0,0,0,0,0
10.4018/978-1-5225-9412-3.ch009,73,3,CompositeAPI,2025-07-02T14:56:52.924968+00:00,73,0,0,73,0,73,2,2,1,1,1,3
10.1016/j.tele.2024.102212,86,0,CompositeAPI,2025-07-02T14:56:57.973104+00:00,86,0,0,86,0,86,0,0,0,0,0,0
10.1186/1479-5868-8-90,44,44,CompositeAPI,2025-07-02T14:57:02.419591+00:00,43,40,39,4,1,44,40,41,37,3,4,44
10.1016/j.telpol.2012.09.008,36,28,CompositeAPI,2025-07-02T14:57:06.730178+00:00,36,0,0,36,0,36,27,27,26,1,1,28
10.1186/s12889-018-5674-4,39,33,CompositeAPI,2025-07-02T14:57:11.119341+00:00,37,36,34,3,2,39,33,22,22,11,0,33
10.1080/13229400.2022.2040575,25,17,CompositeAPI,2025-07-02T14:57:15.399538+00:00,21,23,19,2,4,25,15,12,10,5,2,17
10.1016/j.appet.2017.08.018,49,36,CompositeAPI,2025-07-02T14:57:18.512792+00:00,49,0,0,49,0,49,36,30,30,6,0,36
10.1177/1527002518762551,25,25,CompositeAPI,2025-07-02T14:57:22.840762+00:00,25,0,0,25,0,25,21,21,17,4,4,25
10.1146/annurev.soc.27.1.307,116,1724,CompositeAPI,2025-07-02T14:57:26.874588+00:00,116,0,0,116,0,116,1627,1345,1248,379,97,1724
10.1080/0144929x.2024.2406255,103,2,CompositeAPI,2025-07-02T14:57:50.543307+00:00,86,94,77,9,17,103,2,2,2,0,0,2
10.1016/j.econedurev.2017.01.001,30,36,CompositeAPI,2025-07-02T14:58:17.234695+00:00,30,0,0,30,0,30,27,25,16,11,9,36
10.1111/sjop.12467,30,16,CompositeAPI,2025-07-02T14:58:21.966690+00:00,30,0,0,30,0,30,15,12,11,4,1,16
10.1186/1471-2458-9-146,39,40,CompositeAPI,2025-07-02T14:58:26.151600+00:00,39,0,0,39,0,39,40,0,0,40,0,40
10.1002/wps.20820,7,75,CompositeAPI,2025-07-02T14:58:30.748250+00:00,7,0,0,7,0,7,73,59,57,16,2,75
10.1177/2167479516688438,48,41,CompositeAPI,2025-07-02T14:58:33.913785+00:00,48,0,0,48,0,48,40,30,29,11,1,41
10.1177/0093650216686877,75,72,CompositeAPI,2025-07-02T14:58:39.234145+00:00,75,0,0,75,0,75,69,59,56,13,3,72
10.1016/j.chb.2020.106355,70,12,CompositeAPI,2025-07-02T14:58:45.530464+00:00,66,66,62,4,4,70,12,8,8,4,0,12
10.1016/j.copsyc.2022.101339,38,85,CompositeAPI,2025-07-02T14:58:50.797083+00:00,38,0,0,38,0,38,82,62,59,23,3,85
10.1007/s10648-017-9430-6,91,79,CompositeAPI,2025-07-02T14:59:03.191738+00:00,91,0,0,91,0,91,79,0,0,79,0,79
10.1371/journal.pmed.1003212,47,55,CompositeAPI,2025-07-02T14:59:22.963760+00:00,45,47,45,0,2,47,52,47,44,8,3,55
10.1207/s15327736me1701_2,18,364,CompositeAPI,2025-07-02T14:59:27.276619+00:00,18,0,0,18,0,18,337,297,270,67,27,364
10.1186/1479-5868-11-46,19,34,CompositeAPI,2025-07-02T14:59:33.525403+00:00,18,15,14,4,1,19,32,29,27,5,2,34
10.1177/1461444817737296,39,39,CompositeAPI,2025-07-02T14:59:36.928516+00:00,39,0,0,39,0,39,38,28,27,11,1,39
10.3390/children9081186,40,0,CompositeAPI,2025-07-02T14:59:41.025777+00:00,37,38,35,2,3,40,0,0,0,0,0,0
10.1007/s11205-015-1227-8,42,106,CompositeAPI,2025-07-02T14:59:43.645829+00:00,42,0,0,42,0,42,101,89,84,17,5,106
10.1111/j.1083-6101.2007.00368.x,50,644,CompositeAPI,2025-07-02T14:59:48.972179+00:00,50,0,0,50,0,50,608,545,509,99,36,644
10.1542/peds.2017-2674,6,8,CompositeAPI,2025-07-02T15:00:24.945894+00:00,6,0,0,6,0,6,8,7,7,1,0,8
10.21659/rupkatha.v8n4.11,3,1,CompositeAPI,2025-07-02T15:00:27.970757+00:00,1,2,0,1,2,3,1,0,0,1,0,1
10.1016/j.actpsy.2021.103454,104,31,CompositeAPI,2025-07-02T15:00:30.949893+00:00,79,100,75,4,25,104,29,26,24,5,2,31
10.3390/ijerph20043771,59,6,CompositeAPI,2025-07-02T15:00:37.199348+00:00,56,58,55,1,3,59,5,6,5,0,1,6
10.1055/s-0038-1626338,19,12,CompositeAPI,2025-07-02T15:00:42.253499+00:00,19,0,0,19,0,19,9,11,8,1,3,12
10.1080/17482798.2024.2443662,73,1,CompositeAPI,2025-07-02T15:01:04.825444+00:00,73,0,0,73,0,73,1,1,1,0,0,1
10.1177/2167702619898179,27,11,CompositeAPI,2025-07-02T15:01:13.303496+00:00,27,0,0,27,0,27,10,7,6,4,1,11
10.1037/dev0000399,73,65,CompositeAPI,2025-07-02T15:01:17.240985+00:00,73,0,0,73,0,73,59,41,35,24,6,65
10.4278/ajhp.07053050,18,11,CompositeAPI,2025-07-02T15:01:24.039002+00:00,17,13,12,5,1,18,10,9,8,2,1,11
10.1007/s40675-019-00146-x,95,55,CompositeAPI,2025-07-02T15:01:27.195686+00:00,95,0,0,95,0,95,52,43,40,12,3,55
10.3305/nh.2013.28.sup5.6924,28,42,CompositeAPI,2025-07-02T15:01:33.676693+00:00,28,0,0,28,0,28,38,37,33,5,4,42
10.1080/15213269.2019.1624177,52,39,CompositeAPI,2025-07-02T15:01:37.831960+00:00,52,0,0,52,0,52,39,33,33,6,0,39
10.2501/s026504870909043x,0,36,CompositeAPI,2025-07-02T15:01:43.054975+00:00,0,0,0,0,0,0,32,33,29,3,4,36
10.1207/s15506878jobem4402_4,15,210,CompositeAPI,2025-07-02T15:01:46.110487+00:00,15,0,0,15,0,15,195,183,168,27,15,210
10.1016/j.tele.2015.08.002,40,16,CompositeAPI,2025-07-02T15:01:50.977914+00:00,40,0,0,40,0,40,16,13,13,3,0,16
10.1108/sbm-08-2020-0080,74,5,CompositeAPI,2025-07-02T15:01:54.910361+00:00,74,0,0,74,0,74,5,3,3,2,0,5
10.1007/s11469-013-9461-2,52,76,CompositeAPI,2025-07-02T15:02:01.086018+00:00,52,0,0,52,0,52,70,63,57,13,6,76
10.1207/s15506878jobem4403_1,23,104,CompositeAPI,2025-07-02T15:02:06.539692+00:00,23,0,0,23,0,23,104,7,7,97,0,104
10.1007/s12187-019-09675-x,47,46,CompositeAPI,2025-07-02T15:02:11.749531+00:00,47,0,0,47,0,47,46,0,0,46,0,46
10.3390/ijerph17197122,40,10,CompositeAPI,2025-07-02T15:02:16.893202+00:00,37,38,35,2,3,40,8,9,7,1,2,10
10.1016/j.sleep.2021.02.045,62,7,CompositeAPI,2025-07-02T15:02:20.985889+00:00,62,0,0,62,0,62,7,0,0,7,0,7
10.1016/j.sleep.2017.09.002,55,16,CompositeAPI,2025-07-02T15:02:26.103645+00:00,54,48,47,7,1,55,16,14,14,2,0,16
10.1080/15213269.2016.1257393,55,55,CompositeAPI,2025-07-02T15:02:31.003489+00:00,55,0,0,55,0,55,51,47,43,8,4,55
10.1080/17482798.2024.2358947,41,0,CompositeAPI,2025-07-02T15:02:36.396886+00:00,36,38,33,3,5,41,0,0,0,0,0,0
10.1089/cyber.2022.0057,10,1,CompositeAPI,2025-07-02T15:02:38.946460+00:00,10,0,0,10,0,10,1,0,0,1,0,1
10.1108/itp-07-2023-0676,117,1,CompositeAPI,2025-07-02T15:02:41.976261+00:00,100,111,94,6,17,117,1,1,1,0,0,1
10.1080/15205436.2018.1490434,30,147,CompositeAPI,2025-07-02T15:02:48.005555+00:00,30,0,0,30,0,30,136,109,98,38,11,147
10.1007/s11205-010-9656-x,20,30,CompositeAPI,2025-07-02T15:02:52.865442+00:00,20,0,0,20,0,20,29,21,20,9,1,30
10.1080/08838159209364182,10,17,CompositeAPI,2025-07-02T15:02:56.219910+00:00,10,0,0,10,0,10,11,17,11,0,6,17
10.1071/he12058,33,121,CompositeAPI,2025-07-02T15:02:59.303636+00:00,33,0,0,33,0,33,114,99,92,22,7,121
10.1080/1369118x.2011.562223,25,45,CompositeAPI,2025-07-02T15:03:04.650740+00:00,25,0,0,25,0,25,44,30,29,15,1,45
10.1177/0735633117707792,35,5,CompositeAPI,2025-07-02T15:03:08.595566+00:00,35,0,0,35,0,35,5,5,5,0,0,5
10.1016/j.ypmed.2016.08.033,64,26,CompositeAPI,2025-07-02T15:03:12.639474+00:00,62,55,53,9,2,64,24,23,21,3,2,26
10.1016/j.chbr.2023.100293,30,2,CompositeAPI,2025-07-02T15:03:18.161407+00:00,29,27,26,3,1,30,2,2,2,0,0,2
10.1177/0033294117742657,25,11,CompositeAPI,2025-07-02T15:03:22.018505+00:00,25,0,0,25,0,25,10,9,8,2,1,11
10.1186/s12889-020-09894-w,37,17,CompositeAPI,2025-07-02T15:03:25.114869+00:00,35,35,33,2,2,37,15,14,12,3,2,17
10.1037/ppm0000203,85,590,CompositeAPI,2025-07-02T15:03:29.246775+00:00,85,0,0,85,0,85,558,445,413,145,32,590
2394618024,0,1,CompositeAPI,2025-07-02T15:03:39.803291+00:00,0,0,0,0,0,0,0,1,0,0,1,1
10.3389/fpsyg.2020.01734,48,34,CompositeAPI,2025-07-02T15:03:41.229715+00:00,41,44,37,4,7,48,33,26,25,8,1,34
10.1111/dar.13685,52,12,CompositeAPI,2025-07-02T15:03:45.575827+00:00,51,46,45,6,1,52,10,10,8,2,2,12
10.1177/0093650208315979,23,151,CompositeAPI,2025-07-02T15:03:50.476113+00:00,23,0,0,23,0,23,148,108,105,43,3,151
10.1037/tmb0000127,0,12,CompositeAPI,2025-07-02T15:03:55.386936+00:00,0,0,0,0,0,0,9,9,6,3,3,12
10.1080/16138171.2020.1792072,32,15,CompositeAPI,2025-07-02T15:03:58.130118+00:00,32,0,0,32,0,32,15,12,12,3,0,15
10.51866/rv1143,36,41,CompositeAPI,2025-07-02T15:04:02.248440+00:00,34,31,29,5,2,36,39,17,15,24,2,41
10.1177/0267323112453672,30,11,CompositeAPI,2025-07-02T15:04:06.408273+00:00,30,0,0,30,0,30,11,8,8,3,0,11
10.2196/22740,71,59,CompositeAPI,2025-07-02T15:04:10.466062+00:00,66,65,60,6,5,71,58,48,47,11,1,59
10.1177/1461444809341859,58,101,CompositeAPI,2025-07-02T15:04:15.691011+00:00,58,0,0,58,0,58,96,90,85,11,5,101
10.1159/000086877,7,0,CompositeAPI,2025-07-02T15:04:21.537152+00:00,7,0,0,7,0,7,0,0,0,0,0,0
10.1080/1369118x.2013.777760,45,96,CompositeAPI,2025-07-02T15:04:24.438053+00:00,45,0,0,45,0,45,95,68,67,28,1,96
10.1016/j.infoecopol.2021.100927,23,8,CompositeAPI,2025-07-02T15:04:29.709945+00:00,23,0,0,23,0,23,7,5,4,3,1,8
10.1093/ct/qtad016,122,20,CompositeAPI,2025-07-02T15:04:33.983924+00:00,116,112,106,10,6,122,20,18,18,2,0,20
10.1371/journal.pone.0142544,39,42,CompositeAPI,2025-07-02T15:04:40.943670+00:00,38,34,33,5,1,39,36,41,35,1,6,42
10.1002/jad.12376,76,2,CompositeAPI,2025-07-02T15:04:45.113302+00:00,76,0,0,76,0,76,2,2,2,0,0,2
10.1037/ppm0000479,0,0,CompositeAPI,2025-07-02T15:04:51.051791+00:00,0,0,0,0,0,0,0,0,0,0,0,0
10.1096/fasebj.26.1_supplement.1011.5,0,0,CompositeAPI,2025-07-02T15:04:52.254249+00:00,0,0,0,0,0,0,0,0,0,0,0,0
10.3389/fpsyg.2023.1279893,32,1,CompositeAPI,2025-07-02T15:04:53.505350+00:00,32,32,32,0,0,32,1,1,1,0,0,1
10.1177/0093650210384988,47,124,CompositeAPI,2025-07-02T15:04:57.505873+00:00,47,0,0,47,0,47,116,107,99,17,8,124
10.1007/s11205-008-9414-5,6,8,CompositeAPI,2025-07-02T15:05:03.146605+00:00,6,0,0,6,0,6,8,6,6,2,0,8
1550314631,39,55,CompositeAPI,2025-07-02T15:05:06.246044+00:00,39,0,0,39,0,39,41,37,23,18,14,55
10.3389/fpsyg.2021.742468,75,7,CompositeAPI,2025-07-02T15:05:13.560540+00:00,65,74,64,1,10,75,7,6,6,1,0,7
10.1111/0038-4941.00026,13,118,CompositeAPI,2025-07-02T15:05:18.826968+00:00,13,0,0,13,0,13,114,103,99,15,4,118
10.1051/shsconf/20173300065,18,4,CompositeAPI,2025-07-02T15:05:22.841970+00:00,18,18,18,0,0,18,2,4,2,0,2,4
2126311508,26,107,CompositeAPI,2025-07-02T15:05:25.984829+00:00,26,0,0,26,0,26,82,93,68,14,25,107
10.1111/j.1475-682x.1997.tb00432.x,20,11,CompositeAPI,2025-07-02T15:05:32.712196+00:00,20,0,0,20,0,20,10,8,7,3,1,11
10.1111/j.1460-2466.2003.tb02590.x,22,80,CompositeAPI,2025-07-02T15:05:35.803281+00:00,22,0,0,22,0,22,79,71,70,9,1,80
10.1123/pes.2012-0128,0,14,CompositeAPI,2025-07-02T15:05:39.810069+00:00,0,0,0,0,0,0,14,13,13,1,0,14
10.1016/j.chb.2016.04.043,74,225,CompositeAPI,2025-07-02T15:05:42.669655+00:00,74,0,0,74,0,74,213,185,173,40,12,225
10.1080/10810730.2016.1157651,63,41,CompositeAPI,2025-07-02T15:05:50.897310+00:00,63,0,0,63,0,63,39,26,24,15,2,41
10.1080/23311886.2022.2042113,35,5,CompositeAPI,2025-07-02T15:05:57.396725+00:00,34,34,33,1,1,35,4,3,2,2,1,5
10.1111/j.1083-6101.2009.01451.x,46,276,CompositeAPI,2025-07-02T15:06:01.306021+00:00,46,0,0,46,0,46,259,230,213,46,17,276
10.1007/s10803-017-3201-6,30,87,CompositeAPI,2025-07-02T15:06:08.072567+00:00,30,0,0,30,0,30,84,61,58,26,3,87
10.1186/s12966-015-0280-7,37,139,CompositeAPI,2025-07-02T15:06:12.437657+00:00,34,31,28,6,3,37,135,125,121,14,4,139
10.3390/ijerph18063227,175,30,CompositeAPI,2025-07-02T15:06:17.736492+00:00,167,160,152,15,8,175,26,21,17,9,4,30
10.1080/17461391.2018.1548649,43,40,CompositeAPI,2025-07-02T15:06:27.967160+00:00,43,0,0,43,0,43,39,30,29,10,1,40
10.1016/j.chb.2012.12.022,73,208,CompositeAPI,2025-07-02T15:06:32.482596+00:00,73,0,0,73,0,73,200,173,165,35,8,208
10.1207/s15506878jobem5004_5,44,134,CompositeAPI,2025-07-02T15:06:40.316072+00:00,44,0,0,44,0,44,128,110,104,24,6,134
10.1111/cdev.13953,49,5,CompositeAPI,2025-07-02T15:06:46.302994+00:00,49,0,0,49,0,49,5,5,5,0,0,5
10.1016/j.telpol.2003.07.001,8,140,CompositeAPI,2025-07-02T15:06:51.158795+00:00,8,0,0,8,0,8,131,117,108,23,9,140
10.1177/1461444809342558,17,61,CompositeAPI,2025-07-02T15:06:55.209195+00:00,17,0,0,17,0,17,60,39,38,22,1,61
10.1016/s0148-2963(96)00067-7,22,71,CompositeAPI,2025-07-02T15:06:58.465359+00:00,22,0,0,22,0,22,66,57,52,14,5,71
10.1016/j.chb.2024.108138,131,6,CompositeAPI,2025-07-02T15:07:02.568619+00:00,119,115,103,16,12,131,4,6,4,0,2,6
10.1080/08997764.2011.601974,30,59,CompositeAPI,2025-07-02T15:07:09.837215+00:00,30,0,0,30,0,30,59,14,14,45,0,59
10.1080/0144929x.2019.1634762,65,9,CompositeAPI,2025-07-02T15:07:14.148933+00:00,65,0,0,65,0,65,8,7,6,2,1,9
10.1080/03004430601119851,31,31,CompositeAPI,2025-07-02T15:07:19.467827+00:00,31,0,0,31,0,31,28,25,22,6,3,31
10.2196/43388,68,38,CompositeAPI,2025-07-02T15:07:23.587697+00:00,64,61,57,7,4,68,33,24,19,14,5,38
10.3389/fpsyt.2022.809745,124,4,CompositeAPI,2025-07-02T15:07:28.791861+00:00,106,118,100,6,18,124,4,4,4,0,0,4
10.1007/s12564-010-9127-8,37,4,CompositeAPI,2025-07-02T15:07:35.728411+00:00,37,0,0,37,0,37,3,4,3,0,1,4
10.1016/j.comppsych.2024.152452,52,10,CompositeAPI,2025-07-02T15:07:39.911946+00:00,50,44,42,8,2,52,10,7,7,3,0,10
10.1037/0012-1649.35.4.912,0,237,CompositeAPI,2025-07-02T15:07:44.068209+00:00,0,0,0,0,0,0,193,202,158,35,44,237
10.1177/1354856514541928,21,32,CompositeAPI,2025-07-02T15:07:47.971487+00:00,21,0,0,21,0,21,32,29,29,3,0,32
10.1177/2057150x221121698,32,4,CompositeAPI,2025-07-02T15:07:51.063761+00:00,32,0,0,32,0,32,3,3,2,1,1,4
10.1001/jamapediatrics.2019.1759,43,372,CompositeAPI,2025-07-02T15:07:54.904644+00:00,43,0,0,43,0,43,361,297,286,75,11,372
10.1007/s40124-023-00290-7,37,1,CompositeAPI,2025-07-02T15:08:02.433205+00:00,37,0,0,37,0,37,1,1,1,0,0,1
10.1093/pch/12.8.698,30,5,CompositeAPI,2025-07-02T15:08:06.480893+00:00,30,0,0,30,0,30,5,5,5,0,0,5
10.1111/1540-5834.00120,126,471,CompositeAPI,2025-07-02T15:08:10.447348+00:00,126,0,0,126,0,126,382,450,361,21,89,471
10.1016/j.mhpa.2020.100344,39,7,CompositeAPI,2025-07-02T15:08:22.997134+00:00,39,0,0,39,0,39,6,7,6,0,1,7
10.1073/pnas.1908630116,28,350,CompositeAPI,2025-07-02T15:08:27.510327+00:00,28,0,0,28,0,28,330,214,194,136,20,350
10.1016/j.copsyc.2021.12.008,46,65,CompositeAPI,2025-07-02T15:08:34.013410+00:00,46,0,0,46,0,46,64,47,46,18,1,65
10.1089/cpb.2006.9939,35,111,CompositeAPI,2025-07-02T15:08:38.442484+00:00,35,0,0,35,0,35,102,91,82,20,9,111
10.1080/08838151.2019.1689072,45,15,CompositeAPI,2025-07-02T15:08:43.534142+00:00,45,0,0,45,0,45,14,11,10,4,1,15
10.1111/ijsw.12609,42,4,CompositeAPI,2025-07-02T15:08:47.553339+00:00,42,0,0,42,0,42,4,4,4,0,0,4
10.2307/747641,16,185,CompositeAPI,2025-07-02T15:08:51.577811+00:00,16,0,0,16,0,16,175,141,131,44,10,185
10.1016/j.smrv.2024.102025,10,1,CompositeAPI,2025-07-02T15:08:56.720114+00:00,10,0,0,10,0,10,1,1,1,0,0,1
10.31820/pt.33.1.2,48,0,CompositeAPI,2025-07-02T15:08:59.695530+00:00,47,43,42,5,1,48,0,0,0,0,0,0
10.1007/s10660-020-09421-4,39,2,CompositeAPI,2025-07-02T15:09:02.256332+00:00,39,0,0,39,0,39,2,0,0,2,0,2
10.1080/1369118x.2016.1164740,41,115,CompositeAPI,2025-07-02T15:09:06.192411+00:00,41,0,0,41,0,41,106,86,77,29,9,115
10.1016/j.jadohealth.2024.11.020,0,0,CompositeAPI,2025-07-02T15:09:12.295835+00:00,0,0,0,0,0,0,0,0,0,0,0,0
10.1016/j.tele.2020.101558,46,11,CompositeAPI,2025-07-02T15:09:13.521994+00:00,46,0,0,46,0,46,10,7,6,4,1,11
10.1177/0002764209331542,26,35,CompositeAPI,2025-07-02T15:09:17.599223+00:00,26,0,0,26,0,26,35,33,33,2,0,35
10.1111/jcc4.12183,51,179,CompositeAPI,2025-07-02T15:09:22.129425+00:00,51,0,0,51,0,51,176,141,138,38,3,179
10.1089/1094931041291303,17,400,CompositeAPI,2025-07-02T15:09:28.154699+00:00,17,0,0,17,0,17,367,340,307,60,33,400
10.1089/cyber.2013.0466,28,63,CompositeAPI,2025-07-02T15:09:35.763032+00:00,28,0,0,28,0,28,59,53,49,10,4,63
10.1080/1369118x.2018.1430162,35,98,CompositeAPI,2025-07-02T15:09:40.007493+00:00,35,0,0,35,0,35,95,64,61,34,3,98
10.1037/0000100-023,0,4,CompositeAPI,2025-07-02T15:09:44.473380+00:00,0,0,0,0,0,0,4,1,1,3,0,4
10.1111/j.1468-2958.1987.tb00120.x,23,46,CompositeAPI,2025-07-02T15:09:47.121945+00:00,23,0,0,23,0,23,45,39,38,7,1,46
10.1177/0267323198013004003,12,30,CompositeAPI,2025-07-02T15:09:51.485621+00:00,12,0,0,12,0,12,28,27,25,3,2,30
10.1016/j.smrv.2024.101933,118,37,CompositeAPI,2025-07-02T15:09:54.570034+00:00,111,111,104,7,7,118,35,33,31,4,2,37
10.1016/j.tele.2011.06.001,18,103,CompositeAPI,2025-07-02T15:10:01.858245+00:00,18,0,0,18,0,18,100,88,85,15,3,103
10.1177/1461444818804775,29,77,CompositeAPI,2025-07-02T15:10:05.866374+00:00,29,0,0,29,0,29,73,56,52,21,4,77
10.1155/2022/1402751,46,19,CompositeAPI,2025-07-02T15:10:10.102374+00:00,44,38,36,8,2,46,19,15,15,4,0,19
10.1016/j.chb.2020.106550,60,73,CompositeAPI,2025-07-02T15:10:14.511076+00:00,55,51,46,9,5,60,71,49,47,24,2,73
10.1016/j.pcl.2024.07.032,70,0,CompositeAPI,2025-07-02T15:10:19.796708+00:00,70,0,0,70,0,70,0,0,0,0,0,0
10.1177/14614448241301741,59,2,CompositeAPI,2025-07-02T15:10:23.397568+00:00,59,0,0,59,0,59,1,2,1,0,1,2
10.1353/sof.2003.0086,12,123,CompositeAPI,2025-07-02T15:10:28.325552+00:00,12,0,0,12,0,12,115,99,91,24,8,123
10.1080/09546553.2021.1908270,0,2,CompositeAPI,2025-07-02T15:10:32.654693+00:00,0,0,0,0,0,0,2,2,2,0,0,2
10.1016/j.infoecopol.2023.101045,24,4,CompositeAPI,2025-07-02T15:10:35.308261+00:00,21,19,16,5,3,24,3,3,2,1,1,4
10.1007/978-3-319-28640-2_4,31,54,CompositeAPI,2025-07-02T15:10:38.302432+00:00,31,0,0,31,0,31,47,35,28,19,7,54
10.1093/jcmc/zmaa010,52,6,CompositeAPI,2025-07-02T15:10:42.459775+00:00,52,0,0,52,0,52,6,5,5,1,0,6
10.1177/20501579231185479,54,5,CompositeAPI,2025-07-02T15:10:47.765269+00:00,44,49,39,5,10,54,5,4,4,1,0,5
10.1177/08944393241235182,42,1,CompositeAPI,2025-07-02T15:10:51.775812+00:00,39,38,35,4,3,42,1,1,1,0,0,1
10.1080/15213269.2024.2400571,57,0,CompositeAPI,2025-07-02T15:10:55.769285+00:00,57,0,0,57,0,57,0,0,0,0,0,0
10.1093/jcmc/zmy011,46,6,CompositeAPI,2025-07-02T15:10:59.211901+00:00,46,0,0,46,0,46,6,4,4,2,0,6
10.1016/j.cjca.2020.04.015,58,6,CompositeAPI,2025-07-02T15:11:04.129202+00:00,58,0,0,58,0,58,5,5,4,1,1,6
10.1177/0093650210377196,66,208,CompositeAPI,2025-07-02T15:11:09.188905+00:00,66,0,0,66,0,66,198,177,167,31,10,208
10.1080/08838159909364493,28,58,CompositeAPI,2025-07-02T15:11:16.153308+00:00,28,0,0,28,0,28,53,50,45,8,5,58
10.1177/107769900207900412,0,144,CompositeAPI,2025-07-02T15:11:20.576834+00:00,0,0,0,0,0,0,134,132,122,12,10,144
10.5546/aap.2024-10451.eng,14,2,CompositeAPI,2025-07-02T15:11:24.344792+00:00,0,14,0,0,14,14,2,1,1,1,0,2
10.1093/jcmc/zmz013,60,243,CompositeAPI,2025-07-02T15:11:27.204394+00:00,60,0,0,60,0,60,243,0,0,243,0,243
10.1080/00222216.2012.11950252,42,62,CompositeAPI,2025-07-02T15:11:34.495613+00:00,42,0,0,42,0,42,58,49,45,13,4,62
10.1111/j.1467-6451.2007.00316.x,10,139,CompositeAPI,2025-07-02T15:11:38.960633+00:00,10,0,0,10,0,10,125,110,96,29,14,139
10.12809/eaapl946,0,0,CompositeAPI,2025-07-02T15:11:43.091601+00:00,0,0,0,0,0,0,0,0,0,0,0,0
10.3389/fpsyg.2020.02224,57,32,CompositeAPI,2025-07-02T15:11:44.136466+00:00,51,53,47,4,6,57,31,23,22,9,1,32
10.1108/apjml-05-2020-0377,59,4,CompositeAPI,2025-07-02T15:11:49.200369+00:00,59,0,0,59,0,59,4,1,1,3,0,4
10.1177/001100008100900412,17,1,CompositeAPI,2025-07-02T15:11:54.164639+00:00,17,0,0,17,0,17,0,1,0,0,1,1
10.1080/08997764.2021.1918698,43,3,CompositeAPI,2025-07-02T15:11:55.697250+00:00,43,0,0,43,0,43,2,1,0,2,1,3
10.3389/fpsyg.2022.985112,102,12,CompositeAPI,2025-07-02T15:11:59.655020+00:00,96,97,91,5,6,102,11,9,8,3,1,12
10.1515/commun-2020-0028,33,9,CompositeAPI,2025-07-02T15:12:06.754626+00:00,33,0,0,33,0,33,8,6,5,3,1,9
10.1007/s10826-022-02252-x,34,7,CompositeAPI,2025-07-02T15:12:11.089165+00:00,26,32,24,2,8,34,7,6,6,1,0,7
10.1177/089443939901700207,4,60,CompositeAPI,2025-07-02T15:12:15.086907+00:00,4,0,0,4,0,4,54,47,41,13,6,60
10.1016/j.chb.2014.05.004,116,82,CompositeAPI,2025-07-02T15:12:18.243972+00:00,116,0,0,116,0,116,74,65,57,17,8,82
10.1186/1471-2458-9-212,64,8,CompositeAPI,2025-07-02T15:12:26.563909+00:00,64,0,0,64,0,64,8,0,0,8,0,8
10.1123/jpah.9.7.977,30,76,CompositeAPI,2025-07-02T15:12:31.938125+00:00,30,0,0,30,0,30,64,65,53,11,12,76
10.1027/1864-1105/a000038,69,28,CompositeAPI,2025-07-02T15:12:36.108444+00:00,69,0,0,69,0,69,28,24,24,4,0,28
10.17269/s41997-019-00289-y,28,47,CompositeAPI,2025-07-02T15:12:42.128901+00:00,26,27,25,1,2,28,46,35,34,12,1,47
10.4324/9781351130912-5,1,0,CompositeAPI,2025-07-02T15:12:46.453118+00:00,1,0,0,1,0,1,0,0,0,0,0,0
10.1016/j.infbeh.2020.101509,70,40,CompositeAPI,2025-07-02T15:12:47.850951+00:00,70,0,0,70,0,70,40,33,33,7,0,40
10.1016/j.infoecopol.2016.01.003,36,98,CompositeAPI,2025-07-02T15:12:53.070682+00:00,36,0,0,36,0,36,98,0,0,98,0,98
10.1177/0265407519836170,61,406,CompositeAPI,2025-07-02T15:12:58.045468+00:00,61,0,0,61,0,61,383,323,300,83,23,406
10.1353/cj.2016.0004,0,0,CompositeAPI,2025-07-02T15:13:05.798586+00:00,0,0,0,0,0,0,0,0,0,0,0,0
10.1007/bf02895662,41,91,CompositeAPI,2025-07-02T15:13:07.285026+00:00,41,0,0,41,0,41,86,81,76,10,5,91
10.1080/1369118x.2024.2317898,38,2,CompositeAPI,2025-07-02T15:13:11.486537+00:00,38,0,0,38,0,38,1,1,0,1,1,2
2388919292,28,35,CompositeAPI,2025-07-02T15:13:15.440615+00:00,28,0,0,28,0,28,14,31,10,4,21,35
10.1016/j.tele.2015.06.014,38,89,CompositeAPI,2025-07-02T15:13:20.554156+00:00,38,0,0,38,0,38,85,77,73,12,4,89
10.1177/15270025241240393,29,0,CompositeAPI,2025-07-02T15:13:24.755078+00:00,29,0,0,29,0,29,0,0,0,0,0,0
10.1177/1461444805049139,27,16,CompositeAPI,2025-07-02T15:13:27.083135+00:00,27,0,0,27,0,27,16,15,15,1,0,16
10.1007/s40279-022-01682-3,60,8,CompositeAPI,2025-07-02T15:13:30.964759+00:00,60,0,0,60,0,60,7,7,6,1,1,8
10.1080/00140139.2013.820843,63,26,CompositeAPI,2025-07-02T15:13:36.029855+00:00,63,0,0,63,0,63,26,21,21,5,0,26
10.4324/9780203855102,0,89,CompositeAPI,2025-07-02T15:13:42.007994+00:00,0,0,0,0,0,0,74,36,21,53,15,89
10.1016/s2352-4642(19)30424-9,31,41,CompositeAPI,2025-07-02T15:13:45.033698+00:00,31,0,0,31,0,31,40,29,28,12,1,41
10.1080/10410236.2017.1422103,26,26,CompositeAPI,2025-07-02T15:13:49.273596+00:00,26,0,0,26,0,26,25,23,22,3,1,26
3043600907,0,7,CompositeAPI,2025-07-02T15:13:53.812601+00:00,0,0,0,0,0,0,4,5,2,2,3,7
10.3390/su12062554,24,17,CompositeAPI,2025-07-02T15:13:56.945597+00:00,24,0,0,24,0,24,17,0,0,17,0,17
10.1007/s41105-021-00345-6,39,8,CompositeAPI,2025-07-02T15:14:01.003198+00:00,39,0,0,39,0,39,8,7,7,1,0,8
10.1016/s0747-5632(02)00016-x,14,145,CompositeAPI,2025-07-02T15:14:05.038242+00:00,14,0,0,14,0,14,134,128,117,17,11,145
10.1089/g4h.2017.0177,45,8,CompositeAPI,2025-07-02T15:14:09.162403+00:00,45,0,0,45,0,45,7,7,6,1,1,8
10.1016/j.amepre.2007.07.009,27,123,CompositeAPI,2025-07-02T15:14:13.344974+00:00,27,0,0,27,0,27,117,117,111,6,6,123
10.1016/j.tourman.2008.12.012,52,153,CompositeAPI,2025-07-02T15:14:18.323216+00:00,52,0,0,52,0,52,146,120,113,33,7,153
10.1016/j.actpsy.2024.104674,123,1,CompositeAPI,2025-07-02T15:14:24.237630+00:00,123,0,0,123,0,123,0,1,0,0,1,1
10.1016/j.lisr.2017.07.002,33,9,CompositeAPI,2025-07-02T15:14:29.751518+00:00,33,0,0,33,0,33,9,7,7,2,0,9
10.4018/ijcbpl.2016100101,25,16,CompositeAPI,2025-07-02T15:14:33.896347+00:00,25,0,0,25,0,25,13,14,11,2,3,16
10.1016/j.aap.2019.04.017,44,51,CompositeAPI,2025-07-02T15:14:37.918509+00:00,44,0,0,44,0,44,50,44,43,7,1,51
10.1002/casp.2138,46,12,CompositeAPI,2025-07-02T15:14:43.058819+00:00,46,0,0,46,0,46,12,11,11,1,0,12
10.1093/aje/kwp163,29,446,CompositeAPI,2025-07-02T15:14:47.158363+00:00,29,0,0,29,0,29,443,131,128,315,3,446
10.1111/%28issn%291651-2227,0,0,CompositeAPI,2025-07-02T15:14:55.164695+00:00,0,0,0,0,0,0,0,0,0,0,0,0
10.3390/biology11010111,38,7,CompositeAPI,2025-07-02T15:14:56.366632+00:00,36,35,33,3,2,38,7,7,7,0,0,7
2775789439,0,4,CompositeAPI,2025-07-02T15:15:00.479563+00:00,0,0,0,0,0,0,2,3,1,1,2,4
10.1016/j.sbspro.2011.10.239,8,9,CompositeAPI,2025-07-02T15:15:03.724019+00:00,8,7,7,1,0,8,9,5,5,4,0,9
3138176270,15,8,CompositeAPI,2025-07-02T15:15:06.865166+00:00,15,0,0,15,0,15,8,0,0,8,0,8
10.1080/16522354.2024.2418718,58,1,CompositeAPI,2025-07-02T15:15:10.672209+00:00,57,45,44,13,1,58,1,1,1,0,0,1
10.1080/13504851.2018.1528331,13,3,CompositeAPI,2025-07-02T15:15:15.773937+00:00,13,0,0,13,0,13,3,3,3,0,0,3
10.1287/mksc.2022.0080,19,10,CompositeAPI,2025-07-02T15:15:18.751615+00:00,13,13,7,6,6,19,8,6,4,4,2,10
10.1080/1369118x.2010.539243,26,39,CompositeAPI,2025-07-02T15:15:21.737052+00:00,26,0,0,26,0,26,36,31,28,8,3,39
10.1249/mss.0000000000001002,33,50,CompositeAPI,2025-07-02T15:15:25.651791+00:00,33,0,0,33,0,33,50,40,40,10,0,50
10.1177/02654075221087942,108,36,CompositeAPI,2025-07-02T15:15:30.168621+00:00,108,0,0,108,0,108,35,29,28,7,1,36
10.1093/aje/kws590,21,149,CompositeAPI,2025-07-02T15:15:37.199040+00:00,21,0,0,21,0,21,149,0,0,149,0,149
10.1177/089443930001800411,8,127,CompositeAPI,2025-07-02T15:15:41.425901+00:00,8,0,0,8,0,8,122,104,99,23,5,127
10.1016/j.techfore.2017.06.023,114,67,CompositeAPI,2025-07-02T15:15:45.409529+00:00,114,0,0,114,0,114,61,56,50,11,6,67
10.1016/j.chb.2024.108235,85,14,CompositeAPI,2025-07-02T15:15:52.744983+00:00,82,78,75,7,3,85,13,13,12,1,1,14
10.1111/apa.12935,26,29,CompositeAPI,2025-07-02T15:15:58.783651+00:00,26,0,0,26,0,26,27,29,27,0,2,29
10.1542/peds.2011-1066,116,335,CompositeAPI,2025-07-02T15:16:02.846745+00:00,116,0,0,116,0,116,315,277,257,58,20,335
10.1177/1745691617713052,135,597,CompositeAPI,2025-07-02T15:16:14.751356+00:00,135,0,0,135,0,135,570,459,432,138,27,597
10.1007/s40501-024-00312-1,62,6,CompositeAPI,2025-07-02T15:16:27.324621+00:00,62,0,0,62,0,62,6,5,5,1,0,6
10.1177/1461444810363452,34,213,CompositeAPI,2025-07-02T15:16:32.392837+00:00,34,0,0,34,0,34,201,153,141,60,12,213
10.1177/0044118x19868365,63,36,CompositeAPI,2025-07-02T15:16:38.433733+00:00,63,0,0,63,0,63,36,20,20,16,0,36
10.1177/2055207619844870,37,18,CompositeAPI,2025-07-02T15:16:43.641473+00:00,37,36,36,1,0,37,17,15,14,3,1,18
10.4018/978-1-4666-0315-8.ch030,19,0,CompositeAPI,2025-07-02T15:16:47.733493+00:00,19,0,0,19,0,19,0,0,0,0,0,0
10.1080/1369118x.2016.1164741,33,82,CompositeAPI,2025-07-02T15:16:49.245488+00:00,33,0,0,33,0,33,79,57,54,25,3,82
10.1371/journal.pgph.0004262,60,3,CompositeAPI,2025-07-02T15:16:53.595409+00:00,57,58,55,2,3,60,3,3,3,0,0,3
10.1016/j.rasd.2023.102253,26,7,CompositeAPI,2025-07-02T15:16:58.684510+00:00,26,25,25,1,0,26,7,5,5,2,0,7
10.1108/dpm-04-2019-0125,19,1,CompositeAPI,2025-07-02T15:17:02.607228+00:00,19,0,0,19,0,19,1,0,0,1,0,1
10.1186/1479-5868-7-46,38,191,CompositeAPI,2025-07-02T15:17:05.649995+00:00,37,36,35,2,1,38,180,172,161,19,11,191
10.1111/jsr.12510,23,88,CompositeAPI,2025-07-02T15:17:11.090050+00:00,23,0,0,23,0,23,84,74,70,14,4,88
10.1038/nrendo.2010.133,95,72,CompositeAPI,2025-07-02T15:17:14.442715+00:00,95,0,0,95,0,95,70,57,55,15,2,72
10.1177/0267323113476990e,5,28,CompositeAPI,2025-07-02T15:17:22.461017+00:00,5,0,0,5,0,5,27,2,1,26,1,28
10.1016/s0031-3955(05)70354-0,43,450,CompositeAPI,2025-07-02T15:17:25.494735+00:00,43,0,0,43,0,43,422,394,366,56,28,450
10.1186/s40359-021-00582-x,55,58,CompositeAPI,2025-07-02T15:17:33.828873+00:00,55,0,0,55,0,55,56,30,28,28,2,58
10.1007/s12144-020-01314-x,25,22,CompositeAPI,2025-07-02T15:17:40.145169+00:00,25,0,0,25,0,25,22,20,20,2,0,22
10.1080/1369118x.2017.1414865,21,17,CompositeAPI,2025-07-02T15:17:44.307694+00:00,21,0,0,21,0,21,14,12,9,5,3,17
10.1080/00140130903067789,97,91,CompositeAPI,2025-07-02T15:17:48.230321+00:00,97,0,0,97,0,97,90,77,76,14,1,91
10.1177/0963721419838244,38,265,CompositeAPI,2025-07-02T15:17:56.327009+00:00,38,0,0,38,0,38,246,182,163,83,19,265
10.1515/commun-2014-0028,40,14,CompositeAPI,2025-07-02T15:18:02.450050+00:00,40,0,0,40,0,40,14,0,0,14,0,14
10.1111/j.1460-2466.2008.00401_2.x,0,0,CompositeAPI,2025-07-02T15:18:06.551559+00:00,0,0,0,0,0,0,0,0,0,0,0,0
10.1001/jamapediatrics.2022.4793,66,41,CompositeAPI,2025-07-02T15:18:07.849636+00:00,66,0,0,66,0,66,40,30,29,11,1,41
10.1177/2050157914549039,62,74,CompositeAPI,2025-07-02T15:18:12.917034+00:00,62,0,0,62,0,62,70,60,56,14,4,74
10.1177/20501579221134168,49,5,CompositeAPI,2025-07-02T15:18:18.102279+00:00,49,0,0,49,0,49,5,4,4,1,0,5
10.1177/0956797610362670,29,120,CompositeAPI,2025-07-02T15:18:22.990961+00:00,29,0,0,29,0,29,107,96,83,24,13,120
10.1370/afm.1976,15,148,CompositeAPI,2025-07-02T15:18:27.821866+00:00,15,11,11,4,0,15,141,109,102,39,7,148
10.1371/journal.pone.0024453,73,95,CompositeAPI,2025-07-02T15:18:31.928857+00:00,69,69,65,4,4,73,90,82,77,13,5,95
10.1353/foc.0.0000,12,334,CompositeAPI,2025-07-02T15:18:37.365820+00:00,12,0,0,12,0,12,283,300,249,34,51,334
10.1177/146642400312400110,21,313,CompositeAPI,2025-07-02T15:18:43.331658+00:00,21,0,0,21,0,21,298,280,265,33,15,313
10.1038/s41390-022-02261-y,62,37,CompositeAPI,2025-07-02T15:18:49.264582+00:00,58,57,53,5,4,62,33,31,27,6,4,37
10.1093/ej/ueae091,43,2,CompositeAPI,2025-07-02T15:18:54.434438+00:00,43,0,0,43,0,43,2,2,2,0,0,2
10.1002/hbe2.139,72,199,CompositeAPI,2025-07-02T15:18:58.371679+00:00,72,68,68,4,0,72,191,157,149,42,8,199
10.1207/s15327825mcs0603_3,24,4,CompositeAPI,2025-07-02T15:19:05.327960+00:00,24,0,0,24,0,24,3,3,2,1,1,4
10.1080/15289168.2011.614190,5,3,CompositeAPI,2025-07-02T15:19:09.151544+00:00,5,0,0,5,0,5,2,3,2,0,1,3
10.17323/1813-8918-2023-1-62-70,19,2,CompositeAPI,2025-07-02T15:19:12.083935+00:00,19,0,0,19,0,19,2,0,0,2,0,2
10.1007/s40429-022-00412-z,31,12,CompositeAPI,2025-07-02T15:19:15.159709+00:00,31,0,0,31,0,31,12,11,11,1,0,12
10.1080/10720530290100433,12,15,CompositeAPI,2025-07-02T15:19:19.277881+00:00,12,0,0,12,0,12,15,9,9,6,0,15
10.1016/j.jpubeco.2023.105031,44,5,CompositeAPI,2025-07-02T15:19:22.474788+00:00,36,36,28,8,8,44,3,5,3,0,2,5
10.1016/j.chb.2010.07.015,82,554,CompositeAPI,2025-07-02T15:19:26.389721+00:00,82,0,0,82,0,82,518,449,413,105,36,554
10.1016/j.sleh.2015.11.003,51,160,CompositeAPI,2025-07-02T15:19:36.821662+00:00,51,0,0,51,0,51,150,123,113,37,10,160
10.1093/oxfordhb/9780199873630.013.0009,0,7,CompositeAPI,2025-07-02T15:19:42.883911+00:00,0,0,0,0,0,0,4,6,3,1,3,7
10.1177/0267323102017003692,11,32,CompositeAPI,2025-07-02T15:19:45.515982+00:00,11,0,0,11,0,11,25,28,21,4,7,32
10.1002/9781444302752.ch16,74,7,CompositeAPI,2025-07-02T15:19:49.003970+00:00,74,0,0,74,0,74,6,6,5,1,1,7
10.3389/fpsyt.2022.981881,98,23,CompositeAPI,2025-07-02T15:19:54.888207+00:00,89,93,84,5,9,98,22,19,18,4,1,23
10.1007/s11205-025-03523-y,37,0,CompositeAPI,2025-07-02T15:20:01.102638+00:00,37,0,0,37,0,37,0,0,0,0,0,0
10.1123/jpah.2023-0346,72,11,CompositeAPI,2025-07-02T15:20:03.682881+00:00,72,0,0,72,0,72,10,9,8,2,1,11
10.4103/jmhhb.jmhhb_165_21,32,3,CompositeAPI,2025-07-02T15:20:08.873080+00:00,32,0,0,32,0,32,3,0,0,3,0,3
10.4018/978-1-4666-0315-8.ch026,35,18,CompositeAPI,2025-07-02T15:20:12.863032+00:00,35,0,0,35,0,35,18,0,0,18,0,18
10.1177/08862605231192584,23,2,CompositeAPI,2025-07-02T15:20:17.140593+00:00,23,0,0,23,0,23,2,2,2,0,0,2
10.1016/j.mhpa.2020.100380,40,39,CompositeAPI,2025-07-02T15:20:20.485635+00:00,40,0,0,40,0,40,38,29,28,10,1,39
10.1016/j.tele.2012.02.002,44,27,CompositeAPI,2025-07-02T15:20:24.807754+00:00,44,0,0,44,0,44,26,24,23,3,1,27
10.1177/2167702618778562,7,15,CompositeAPI,2025-07-02T15:20:28.862536+00:00,7,0,0,7,0,7,14,11,10,4,1,15
10.1016/j.adolescence.2013.11.003,44,192,CompositeAPI,2025-07-02T15:20:31.947386+00:00,44,0,0,44,0,44,183,158,149,34,9,192
10.1037/026968,0,0,CompositeAPI,2025-07-02T15:20:38.476831+00:00,0,0,0,0,0,0,0,0,0,0,0,0
10.1016/j.chb.2015.05.026,31,113,CompositeAPI,2025-07-02T15:20:39.693797+00:00,31,0,0,31,0,31,107,88,82,25,6,113
10.2307/1162367,0,16,CompositeAPI,2025-07-02T15:20:44.531744+00:00,0,0,0,0,0,0,16,0,0,16,0,16
10.1007/s11205-008-9285-9,18,34,CompositeAPI,2025-07-02T15:20:47.192831+00:00,18,0,0,18,0,18,33,28,27,6,1,34
10.1177/089443939701500107,10,73,CompositeAPI,2025-07-02T15:20:51.119001+00:00,10,0,0,10,0,10,69,51,47,22,4,73
10.1080/07448481.2022.2152690,42,7,CompositeAPI,2025-07-02T15:20:54.397533+00:00,42,0,0,42,0,42,6,5,4,2,1,7
10.1177/20501579221077525,55,12,CompositeAPI,2025-07-02T15:20:58.686852+00:00,55,0,0,55,0,55,12,9,9,3,0,12
10.1016/j.jad.2025.04.032,63,0,CompositeAPI,2025-07-02T15:21:03.855705+00:00,63,0,0,63,0,63,0,0,0,0,0,0
10.1080/01292986.2012.725179,41,12,CompositeAPI,2025-07-02T15:21:07.362405+00:00,41,0,0,41,0,41,11,10,9,2,1,12
10.1111/bjdp.12429,66,24,CompositeAPI,2025-07-02T15:21:11.419956+00:00,66,0,0,66,0,66,21,21,18,3,3,24
10.1093/restud/rdy028,65,122,CompositeAPI,2025-07-02T15:21:16.693675+00:00,65,0,0,65,0,65,122,0,0,122,0,122
10.1007/s10639-023-11638-3,31,7,CompositeAPI,2025-07-02T15:21:23.682304+00:00,31,0,0,31,0,31,7,7,7,0,0,7
10.1016/s1728-869x(09)60020-4,42,5,CompositeAPI,2025-07-02T15:21:27.761141+00:00,40,38,36,4,2,42,5,5,5,0,0,5
10.1016/j.jsams.2014.01.004,25,28,CompositeAPI,2025-07-02T15:21:32.074786+00:00,25,0,0,25,0,25,27,26,25,2,1,28
10.1016/b978-0-12-817319-0.00010-4,28,2,CompositeAPI,2025-07-02T15:21:35.369628+00:00,28,0,0,28,0,28,1,2,1,0,1,2
10.1111/hcre.12081,83,59,CompositeAPI,2025-07-02T15:21:39.204641+00:00,83,0,0,83,0,83,59,46,46,13,0,59
10.1016/j.numecd.2007.07.008,110,525,CompositeAPI,2025-07-02T15:21:45.767529+00:00,110,0,0,110,0,110,500,478,453,47,25,525
10.1177/2333794x19878062,37,21,CompositeAPI,2025-07-02T15:21:57.374271+00:00,33,34,30,3,4,37,20,13,12,8,1,21
10.1080/10494820.2022.2160765,6,3,CompositeAPI,2025-07-02T15:22:01.492997+00:00,6,0,0,6,0,6,3,3,3,0,0,3
10.4324/9781315736495-6,1,4,CompositeAPI,2025-07-02T15:22:04.384701+00:00,1,0,0,1,0,1,3,4,3,0,1,4
10.1177/2050157914550663,28,58,CompositeAPI,2025-07-02T15:22:07.415164+00:00,28,0,0,28,0,28,57,37,36,21,1,58
10.1111/jftr.12384,79,7,CompositeAPI,2025-07-02T15:22:11.851897+00:00,79,0,0,79,0,79,7,5,5,2,0,7
10.1111/jcc4.12091,34,59,CompositeAPI,2025-07-02T15:22:17.991645+00:00,34,0,0,34,0,34,58,56,55,3,1,59
10.1016/j.chb.2014.04.003,58,131,CompositeAPI,2025-07-02T15:22:22.249754+00:00,58,0,0,58,0,58,120,92,81,39,11,131
10.3389/fpsyg.2021.707667,71,29,CompositeAPI,2025-07-02T15:22:28.016073+00:00,67,65,61,6,4,71,25,24,20,5,4,29
10.1123/jpah.6.3.299,0,14,CompositeAPI,2025-07-02T15:22:33.254015+00:00,0,0,0,0,0,0,12,14,12,0,2,14
